AAAAACCACGT -> AAAACCACGTG
AAAACCACGTG -> AAACCACGTGG
AAAACTCACCT -> AAACTCACCTC
AAAAGTTTTGA -> AAAGTTTTGAG
AAAATTTCGTT -> AAATTTCGTTG
AAACCACGTGG -> AACCACGTGGG
AAACGGTTAAA -> AACGGTTAAAC
AAACTAGAAAG -> AACTAGAAAGT
AAACTAGTTGA -> AACTAGTTGAG
AAACTCACCTC -> AACTCACCTCC
AAACTGCACTT -> AACTGCACTTA
AAACTTATCCA -> AACTTATCCAT
AAAGAGGAGTG -> AAGAGGAGTGT
AAAGAGGTAGA -> AAGAGGTAGAA
AAAGCACCCGA -> AAGCACCCGAA
AAAGGTTTTGC -> AAGGTTTTGCC
AAAGTCATTTT -> AAGTCATTTTG
AAAGTTAATCC -> AAGTTAATCCG
AAAGTTCATTT -> AAGTTCATTTA
AAAGTTTTGAG -> AAGTTTTGAGA
AAATATTCTCT -> AATATTCTCTC
AAATCCGTCAG -> AATCCGTCAGA
AAATTATGACA -> AATTATGACAT
AAATTGCAGAG -> AATTGCAGAGC
AAATTTCGTTG -> AATTTCGTTGG
AACAATGTAAC -> ACAATGTAACT
AACACATGCTC -> ACACATGCTCC
AACACATTAGC -> ACACATTAGCT
AACACCGAGTG -> ACACCGAGTGC
AACACTGGAAG -> ACACTGGAAGA
AACAGCGTGGT -> ACAGCGTGGTC
AACAGCTCCTA -> ACAGCTCCTAC
AACATGACAGG -> ACATGACAGGT
AACCACGTGGG -> ACCACGTGGGG
AACCAGGTATA -> ACCAGGTATAC
AACCCGGGTGC -> ACCCGGGTGCC
AACCTAAGACT -> ACCTAAGACTT
AACGCAGTATC -> ACGCAGTATCC
AACGCATGAGG -> ACGCATGAGGA
AACGCTTCCGA -> ACGCTTCCGAC
AACGGTACCGT -> ACGGTACCGTG
AACGGTTAAAC -> ACGGTTAAACT
AACGTACCGGT -> ACGTACCGGTG
AACTAACAGCG -> ACTAACAGCGT
AACTAGAAAGT -> ACTAGAAAGTT
AACTAGTTGAG -> ACTAGTTGAGC
AACTCAACCAG -> ACTCAACCAGG
AACTCACCTCC -> ACTCACCTCCT
AACTGCACTTA -> ACTGCACTTAT
AACTGGGAACG -> ACTGGGAACGG
AACTTATCCAT -> ACTTATCCATC
AAGAAAAACCA -> AGAAAAACCAC
AAGAAGTTAGA -> AGAAGTTAGAT
AAGAATCGATA -> AGAATCGATAC
AAGAATGACGA -> AGAATGACGAC
AAGACACACAT -> AGACACACATG
AAGACTCATCG -> AGACTCATCGG
AAGACTTGTAT -> AGACTTGTATC
AAGAGAGTACA -> AGAGAGTACAC
AAGAGCACTTC -> AGAGCACTTCG
AAGAGGAGTGT -> AGAGGAGTGTC
AAGAGGTAGAA -> AGAGGTAGAAC
AAGAGGTCAAG -> AGAGGTCAAGG
AAGCACCCGAA -> AGCACCCGAAG
AAGCACTTTCG -> AGCACTTTCGA
AAGCCCATACG -> AGCCCATACGT
AAGCCTCCTAG -> AGCCTCCTAGC
AAGCGGAATAA -> AGCGGAATAAA
AAGCTATCGGC -> AGCTATCGGCG
AAGGACCCCAG -> AGGACCCCAGT
AAGGATCTTTC -> AGGATCTTTCG
AAGGCCGAATA -> AGGCCGAATAA
AAGGGATCGCA -> AGGGATCGCAT
AAGGTTTTGCC -> AGGTTTTGCCT
AAGTAAGCTAT -> AGTAAGCTATC
AAGTAATGCGC -> AGTAATGCGCC
AAGTACATGCC -> AGTACATGCCT
AAGTACTCGTG -> AGTACTCGTGG
AAGTAGCCCAT -> AGTAGCCCATC
AAGTCACAAAA -> AGTCACAAAAG
AAGTCATTTTG -> AGTCATTTTGG
AAGTGCCTGCA -> AGTGCCTGCAA
AAGTGCTCTCC -> AGTGCTCTCCT
AAGTTAATCCG -> AGTTAATCCGT
AAGTTAGATTA -> AGTTAGATTAT
AAGTTAGTGGA -> AGTTAGTGGAC
AAGTTCATTTA -> AGTTCATTTAT
AAGTTGTCGCT -> AGTTGTCGCTG
AAGTTTAGTTG -> AGTTTAGTTGC
AAGTTTTGAGA -> AGTTTTGAGAG
AATAAAATTTC -> ATAAAATTTCG
AATAAATTATG -> ATAAATTATGA
AATAAGGACCC -> ATAAGGACCCC
AATAATGCCTC -> ATAATGCCTCA
AATAGTCAATT -> ATAGTCAATTC
AATATACTACG -> ATATACTACGG
AATATTCTCTC -> ATATTCTCTCT
AATCCATATGG -> ATCCATATGGA
AATCCGTCAGA -> ATCCGTCAGAC
AATCCGTTAGT -> ATCCGTTAGTA
AATCCTACATA -> ATCCTACATAT
AATCGATACGT -> ATCGATACGTT
AATCGTAGTTG -> ATCGTAGTTGA
AATCTGAGGAA -> ATCTGAGGAAT
AATGACAAGAC -> ATGACAAGACT
AATGACGACCT -> ATGACGACCTT
AATGATCTGGG -> ATGATCTGGGC
AATGCCTCAAC -> ATGCCTCAACG
AATGCGCCGTC -> ATGCGCCGTCC
AATGGCCCAGC -> ATGGCCCAGCT
AATGGGTCAAA -> ATGGGTCAAAC
AATGGTTTACA -> ATGGTTTACAT
AATGTAACTAA -> ATGTAACTAAC
AATTAATGGTT -> ATTAATGGTTT
AATTATGACAT -> ATTATGACATA
AATTCGCTGCT -> ATTCGCTGCTA
AATTGCAGAGC -> ATTGCAGAGCA
AATTTAACGCT -> ATTTAACGCTT
AATTTAGACAT -> ATTTAGACATA
AATTTCGTTGG -> ATTTCGTTGGT
AATTTGACTAG -> ATTTGACTAGG
ACAAAAGTTTT -> CAAAAGTTTTG
ACAACCTAAGA -> CAACCTAAGAC
ACAAGACTCAT -> CAAGACTCATC
ACAATGTAACT -> CAATGTAACTA
ACACACATGCC -> CACACATGCCG
ACACATGCCGC -> CACATGCCGCA
ACACATGCTCC -> CACATGCTCCT
ACACATTAGCT -> CACATTAGCTA
ACACCCCGTCT -> CACCCCGTCTT
ACACCGAGTGC -> CACCGAGTGCA
ACACGATCCTG -> CACGATCCTGA
ACACTGGAAGA -> CACTGGAAGAG
ACACTGTGAGT -> CACTGTGAGTG
ACACTTTACCA -> CACTTTACCAG
ACAGAAGGGAT -> CAGAAGGGATC
ACAGCGTGGTC -> CAGCGTGGTCG
ACAGCTCCTAC -> CAGCTCCTACT
ACAGGGATCCA -> CAGGGATCCAT
ACAGGTAACTG -> CAGGTAACTGG
ACAGTTGTGAC -> CAGTTGTGACA
ACATAAGAATG -> CATAAGAATGA
ACATAATAGTC -> CATAATAGTCA
ACATATGTTAG -> CATATGTTAGT
ACATATTGCAA -> CATATTGCAAC
ACATGACAGGT -> CATGACAGGTA
ACATGCCAATT -> CATGCCAATTT
ACATGCCGCAC -> CATGCCGCACT
ACATGCCTAGG -> CATGCCTAGGA
ACATGCTCCTC -> CATGCTCCTCT
ACATGGATGAT -> CATGGATGATG
ACATTAGCTAA -> CATTAGCTAAA
ACATTGGCTGA -> CATTGGCTGAT
ACCAAGTAATG -> CCAAGTAATGC
ACCACGTGGGG -> CCACGTGGGGG
ACCAGGCACTC -> CCAGGCACTCT
ACCAGGTATAC -> CCAGGTATACG
ACCATTATTAA -> CCATTATTAAG
ACCCCAGTAAC -> CCCCAGTAACA
ACCCCGTCTTG -> CCCCGTCTTGT
ACCCGAAGTAC -> CCCGAAGTACT
ACCCGGGTGCC -> CCCGGGTGCCT
ACCGAGTGCAA -> CCGAGTGCAAA
ACCGCACTAGT -> CCGCACTAGTA
ACCGGTGATGG -> CCGGTGATGGA
ACCGTGTGAGT -> CCGTGTGAGTG
ACCGTGTGCCA -> CCGTGTGCCAC
ACCTAAGACTT -> CCTAAGACTTG
ACCTCCTCGAA -> CCTCCTCGAAG
ACCTCTCCTTC -> CCTCTCCTTCC
ACCTGTAGGCT -> CCTGTAGGCTG
ACCTGTCTAAA -> CCTGTCTAAAG
ACCTTACTTGG -> CCTTACTTGGG
ACGAAACTAGA -> CGAAACTAGAA
ACGACAGGGAT -> CGACAGGGATC
ACGACCTTACT -> CGACCTTACTT
ACGATCCTGAG -> CGATCCTGAGG
ACGCAGTATCC -> CGCAGTATCCG
ACGCATGAGGA -> CGCATGAGGAT
ACGCCAGGTCC -> CGCCAGGTCCC
ACGCGTCCCCA -> CGCGTCCCCAT
ACGCTCCAGAA -> CGCTCCAGAAG
ACGCTTCCGAC -> CGCTTCCGACA
ACGGATGTCGG -> CGGATGTCGGA
ACGGCCCGGTC -> CGGCCCGGTCC
ACGGCGCAACA -> CGGCGCAACAT
ACGGGAGTTTG -> CGGGAGTTTGC
ACGGGATACAT -> CGGGATACATA
ACGGGTCCCGA -> CGGGTCCCGAT
ACGGTACCGTG -> CGGTACCGTGT
ACGGTTAAACT -> CGGTTAAACTT
ACGTAAGAAAA -> CGTAAGAAAAA
ACGTACCGGTG -> CGTACCGGTGA
ACGTAGCGCCC -> CGTAGCGCCCG
ACGTGAAGAAG -> CGTGAAGAAGT
ACGTGAAGTGC -> CGTGAAGTGCC
ACGTGAATGGC -> CGTGAATGGCC
ACGTGGCGAAA -> CGTGGCGAAAG
ACGTGGGGGTC -> CGTGGGGGTCC
ACGTTTTAGGA -> CGTTTTAGGAT
ACGTTTTGTTG -> CGTTTTGTTGC
ACTAACAGCGT -> CTAACAGCGTG
ACTACATGCCA -> CTACATGCCAA
ACTACGGGTCC -> CTACGGGTCCC
ACTACTTTTGC -> CTACTTTTGCG
ACTAGAAAGTT -> CTAGAAAGTTA
ACTAGCTCACC -> CTAGCTCACCA
ACTAGGCGTCA -> CTAGGCGTCAT
ACTAGTAGGGT -> CTAGTAGGGTG
ACTAGTTGAGC -> CTAGTTGAGCC
ACTCAACCAGG -> CTCAACCAGGT
ACTCACCTCCT -> CTCACCTCCTC
ACTCACGGCCC -> CTCACGGCCCG
ACTCAGGGTAT -> CTCAGGGTATA
ACTCATCGGAT -> CTCATCGGATA
ACTCCAGTTAA -> CTCCAGTTAAG
ACTCGAAGCGG -> CTCGAAGCGGA
ACTCGTGGGTT -> CTCGTGGGTTC
ACTCTCGTCGG -> CTCTCGTCGGG
ACTCTGCTGGT -> CTCTGCTGGTT
ACTGAGTGCCC -> CTGAGTGCCCC
ACTGCAATTAA -> CTGCAATTAAT
ACTGCACTTAT -> CTGCACTTATC
ACTGGAAGAGA -> CTGGAAGAGAG
ACTGGGAACGG -> CTGGGAACGGT
ACTGTCCCCAG -> CTGTCCCCAGT
ACTGTCGGAAA -> CTGTCGGAAAG
ACTGTGAGTGA -> CTGTGAGTGAA
ACTTAGAAGAG -> CTTAGAAGAGC
ACTTATCATGG -> CTTATCATGGT
ACTTATCCATC -> CTTATCCATCC
ACTTCATAACC -> CTTCATAACCC
ACTTCCCGCCG -> CTTCCCGCCGT
ACTTCGTATGG -> CTTCGTATGGA
ACTTGGGAGCG -> CTTGGGAGCGA
ACTTGTATCAG -> CTTGTATCAGC
ACTTTACCAGG -> CTTTACCAGGC
ACTTTCGACGA -> CTTTCGACGAA
ACTTTTGCGTC -> CTTTTGCGTCC
AGAAAAACCAC -> GAAAAACCACG
AGAAAGTTAAT -> GAAAGTTAATC
AGAACACTGGA -> GAACACTGGAA
AGAAGAGCACT -> GAAGAGCACTT
AGAAGGGATCG -> GAAGGGATCGC
AGAAGTACATG -> GAAGTACATGC
AGAAGTTAGAT -> GAAGTTAGATT
AGAATATACTA -> GAATATACTAC
AGAATCGATAC -> GAATCGATACG
AGAATGACGAC -> GAATGACGACC
AGACACACATG -> GACACACATGC
AGACATATGTT -> GACATATGTTA
AGACCTGTCTA -> GACCTGTCTAA
AGACGTGAAGA -> GACGTGAAGAA
AGACTCATCGG -> GACTCATCGGA
AGACTGCAATT -> GACTGCAATTA
AGACTGTCCCC -> GACTGTCCCCA
AGACTTGTATC -> GACTTGTATCA
AGAGACTGCAA -> GAGACTGCAAT
AGAGAGACTGC -> GAGAGACTGCA
AGAGAGTACAC -> GAGAGTACACG
AGAGCACTTCG -> GAGCACTTCGT
AGAGCAGGCTA -> GAGCAGGCTAC
AGAGCATGCCA -> GAGCATGCCAA
AGAGGAGATCT -> GAGGAGATCTC
AGAGGAGTGTC -> GAGGAGTGTCA
AGAGGTAGAAC -> GAGGTAGAACA
AGAGGTCAAGG -> GAGGTCAAGGC
AGAGTACACGA -> GAGTACACGAT
AGATCTCTACT -> GATCTCTACTA
AGATTATCCCT -> GATTATCCCTC
AGCAATCCTAC -> GCAATCCTACA
AGCACCCGAAG -> GCACCCGAAGT
AGCACTTCGTA -> GCACTTCGTAT
AGCACTTTCGA -> GCACTTTCGAC
AGCAGACCTGT -> GCAGACCTGTC
AGCAGGCCACG -> GCAGGCCACGG
AGCAGGCTACT -> GCAGGCTACTG
AGCATAATAAA -> GCATAATAAAT
AGCATCTCGCT -> GCATCTCGCTT
AGCATGCCAAG -> GCATGCCAAGT
AGCCCATACGT -> GCCCATACGTG
AGCCCATCCGA -> GCCCATCCGAA
AGCCGACCATT -> GCCGACCATTA
AGCCTCCTAGC -> GCCTCCTAGCA
AGCCTGCCCCT -> GCCTGCCCCTA
AGCCTGGAGAA -> GCCTGGAGAAT
AGCGAAACTGC -> GCGAAACTGCA
AGCGAGGTGCG -> GCGAGGTGCGG
AGCGCCCGAGT -> GCGCCCGAGTG
AGCGGAATAAA -> GCGGAATAAAA
AGCGTGGTCGG -> GCGTGGTCGGA
AGCTAAATATT -> GCTAAATATTC
AGCTATCGGCG -> GCTATCGGCGT
AGCTCACCAAG -> GCTCACCAAGT
AGCTCAGCAGA -> GCTCAGCAGAC
AGCTCCTACTC -> GCTCCTACTCA
AGCTGGCACTG -> GCTGGCACTGT
AGGAATCCATA -> GGAATCCATAT
AGGAATCTGAG -> GGAATCTGAGG
AGGACCCCAGT -> GGACCCCAGTA
AGGAGAGCATG -> GGAGAGCATGC
AGGAGATCTCT -> GGAGATCTCTA
AGGAGTGTCAC -> GGAGTGTCACG
AGGATACGCCA -> GGATACGCCAG
AGGATCTTTCG -> GGATCTTTCGG
AGGATTACGTA -> GGATTACGTAG
AGGCACTCTCG -> GGCACTCTCGT
AGGCACTTCCC -> GGCACTTCCCG
AGGCATCGCCA -> GGCATCGCCAA
AGGCCACGGCG -> GGCCACGGCGC
AGGCCGAATAA -> GGCCGAATAAG
AGGCGTCATGC -> GGCGTCATGCG
AGGCTACTGAG -> GGCTACTGAGT
AGGCTGGGTTC -> GGCTGGGTTCT
AGGGATCCATA -> GGGATCCATAC
AGGGATCGCAT -> GGGATCGCATT
AGGGCCTCTCA -> GGGCCTCTCAT
AGGGTATAGTT -> GGGTATAGTTT
AGGGTGCCGGT -> GGGTGCCGGTG
AGGTAACTGGG -> GGTAACTGGGA
AGGTAATCGTA -> GGTAATCGTAG
AGGTAGAACAC -> GGTAGAACACT
AGGTAGGTGCT -> GGTAGGTGCTT
AGGTATACGTT -> GGTATACGTTT
AGGTCAAGGCC -> GGTCAAGGCCG
AGGTCCCACCT -> GGTCCCACCTC
AGGTGCGGGTC -> GGTGCGGGTCG
AGGTGCTTCCG -> GGTGCTTCCGC
AGGTTTTGCCT -> GGTTTTGCCTA
AGTAACAATGT -> GTAACAATGTA
AGTAAGCTATC -> GTAAGCTATCG
AGTAATGCGCC -> GTAATGCGCCG
AGTACACCCCG -> GTACACCCCGT
AGTACACGATC -> GTACACGATCC
AGTACATGCCT -> GTACATGCCTA
AGTACTCGTGG -> GTACTCGTGGG
AGTAGCCCATC -> GTAGCCCATCC
AGTAGGGTGCC -> GTAGGGTGCCG
AGTATCCGAAG -> GTATCCGAAGT
AGTATGCTATA -> GTATGCTATAC
AGTCAATTCGC -> GTCAATTCGCT
AGTCACAAAAG -> GTCACAAAAGT
AGTCATTTTGG -> GTCATTTTGGA
AGTCCAGGTAA -> GTCCAGGTAAT
AGTCTGCCTGG -> GTCTGCCTGGA
AGTCTGGTCAT -> GTCTGGTCATC
AGTCTTACCTG -> GTCTTACCTGT
AGTGAAGAATC -> GTGAAGAATCG
AGTGAAGACAC -> GTGAAGACACA
AGTGACGTAAG -> GTGACGTAAGA
AGTGCAAATCC -> GTGCAAATCCG
AGTGCATTTTA -> GTGCATTTTAC
AGTGCCCCATG -> GTGCCCCATGA
AGTGCCTGCAA -> GTGCCTGCAAG
AGTGCCTTGAC -> GTGCCTTGACG
AGTGCTCTCCT -> GTGCTCTCCTG
AGTGGACTAGC -> GTGGACTAGCT
AGTGTAGCAAT -> GTGTAGCAATC
AGTGTCACGGG -> GTGTCACGGGA
AGTGTCACTAC -> GTGTCACTACT
AGTTAAGTTAG -> GTTAAGTTAGT
AGTTAATCCGT -> GTTAATCCGTT
AGTTACGTGAA -> GTTACGTGAAG
AGTTAGATTAT -> GTTAGATTATC
AGTTAGTGGAC -> GTTAGTGGACT
AGTTCATTTAT -> GTTCATTTATC
AGTTGAACAGC -> GTTGAACAGCT
AGTTGAGCCTG -> GTTGAGCCTGG
AGTTGCTTACA -> GTTGCTTACAA
AGTTGTCGCTG -> GTTGTCGCTGG
AGTTGTGACAC -> GTTGTGACACT
AGTTTAGTTGC -> GTTTAGTTGCT
AGTTTGCGTAT -> GTTTGCGTATA
AGTTTGTGGTG -> GTTTGTGGTGT
AGTTTTGAGAG -> GTTTTGAGAGA
AGTTTTTTGAA -> GTTTTTTGAAT
ATAAAATTTCG -> TAAAATTTCGT
ATAAATTATGA -> TAAATTATGAC
ATAACCCGGGT -> TAACCCGGGTG
ATAACGCATGA -> TAACGCATGAG
ATAAGAATGAC -> TAAGAATGACG
ATAAGGACCCC -> TAAGGACCCCA
ATAATAAATTA -> TAATAAATTAT
ATAATAGTCAA -> TAATAGTCAAT
ATAATGACAAG -> TAATGACAAGA
ATAATGCCTCA -> TAATGCCTCAA
ATACATAAGAA -> TACATAAGAAT
ATACCGCACTA -> TACCGCACTAG
ATACGCCAGGT -> TACGCCAGGTC
ATACGTGAATG -> TACGTGAATGG
ATACGTTTTAG -> TACGTTTTAGG
ATACGTTTTGT -> TACGTTTTGTT
ATACTACGGGT -> TACTACGGGTC
ATACTTAGAAG -> TACTTAGAAGA
ATAGCATCTCG -> TAGCATCTCGC
ATAGCTCAGCA -> TAGCTCAGCAG
ATAGGCATCGC -> TAGGCATCGCC
ATAGTCAATTC -> TAGTCAATTCG
ATAGTGTAGCA -> TAGTGTAGCAA
ATAGTTTTTTG -> TAGTTTTTTGA
ATATAACGCAT -> TATAACGCATG
ATATACTACGG -> TATACTACGGG
ATATCCGGCCT -> TATCCGGCCTC
ATATGGATCCT -> TATGGATCCTA
ATATGTGCCAT -> TATGTGCCATA
ATATGTTAGTG -> TATGTTAGTGT
ATATTCTCTCT -> TATTCTCTCTC
ATATTGCAACG -> TATTGCAACGC
ATATTTTTCTT -> TATTTTTCTTG
ATCACAGAAGG -> TCACAGAAGGG
ATCAGCAGGCC -> TCAGCAGGCCA
ATCATGGTTTA -> TCATGGTTTAT
ATCCACTCTGC -> TCCACTCTGCT
ATCCATACTTA -> TCCATACTTAG
ATCCATATGGA -> TCCATATGGAT
ATCCATCCACT -> TCCATCCACTC
ATCCCATCCCT -> TCCCATCCCTG
ATCCCTCTGCT -> TCCCTCTGCTG
ATCCCTGTTTT -> TCCCTGTTTTA
ATCCGAACACA -> TCCGAACACAT
ATCCGAAGTGC -> TCCGAAGTGCT
ATCCGCTGTTC -> TCCGCTGTTCT
ATCCGGCCTCA -> TCCGGCCTCAA
ATCCGTCAGAC -> TCCGTCAGACG
ATCCGTTAGTA -> TCCGTTAGTAC
ATCCTACATAT -> TCCTACATATT
ATCCTATTGTG -> TCCTATTGTGC
ATCCTGAGGTA -> TCCTGAGGTAG
ATCGATACGTT -> TCGATACGTTT
ATCGCATTTAC -> TCGCATTTACT
ATCGCCAATTT -> TCGCCAATTTG
ATCGGATATGT -> TCGGATATGTG
ATCGGCGTCAA -> TCGGCGTCAAC
ATCGTAGTTGA -> TCGTAGTTGAA
ATCTACGACAG -> TCTACGACAGG
ATCTCGCCCGC -> TCTCGCCCGCA
ATCTCGCTTAT -> TCTCGCTTATT
ATCTCTACTAC -> TCTCTACTACA
ATCTGAGGAAT -> TCTGAGGAATC
ATCTGGGCCGA -> TCTGGGCCGAA
ATCTTTCGGTG -> TCTTTCGGTGG
ATGACAAGACT -> TGACAAGACTC
ATGACAGGTAA -> TGACAGGTAAC
ATGACATAATA -> TGACATAATAG
ATGACGACCTT -> TGACGACCTTA
ATGACGCTCCA -> TGACGCTCCAG
ATGAGGATACG -> TGAGGATACGC
ATGAGTTTGTG -> TGAGTTTGTGG
ATGATCTGGGC -> TGATCTGGGCC
ATGATGCGTAA -> TGATGCGTAAT
ATGCCAAGTTG -> TGCCAAGTTGT
ATGCCAATTTA -> TGCCAATTTAG
ATGCCCGTCCG -> TGCCCGTCCGG
ATGCCGCACTC -> TGCCGCACTCC
ATGCCTAGGAA -> TGCCTAGGAAT
ATGCCTCAACG -> TGCCTCAACGT
ATGCGCCGTCC -> TGCGCCGTCCC
ATGCGGGGCCG -> TGCGGGGCCGC
ATGCGTAATGG -> TGCGTAATGGG
ATGCTATACCG -> TGCTATACCGC
ATGCTCCTCTT -> TGCTCCTCTTG
ATGGAAGCACT -> TGGAAGCACTT
ATGGATCCTAT -> TGGATCCTATT
ATGGATGATGC -> TGGATGATGCG
ATGGATTTACT -> TGGATTTACTC
ATGGCCCAGCT -> TGGCCCAGCTG
ATGGGTCAAAC -> TGGGTCAAACT
ATGGTTTACAT -> TGGTTTACATT
ATGGTTTATCT -> TGGTTTATCTC
ATGTAACTAAC -> TGTAACTAACA
ATGTCGGAGTC -> TGTCGGAGTCC
ATGTGCCATAG -> TGTGCCATAGT
ATGTTAGTGTC -> TGTTAGTGTCA
ATTAAGTCACA -> TTAAGTCACAA
ATTAATGGTTT -> TTAATGGTTTA
ATTACGTAGCG -> TTACGTAGCGC
ATTAGACTGTC -> TTAGACTGTCC
ATTAGCTAAAT -> TTAGCTAAATA
ATTATCCCTCT -> TTATCCCTCTG
ATTATGACATA -> TTATGACATAA
ATTATTAAGTC -> TTATTAAGTCA
ATTATTAGACT -> TTATTAGACTG
ATTCGCTGCTA -> TTCGCTGCTAA
ATTCTCTCTCT -> TTCTCTCTCTT
ATTGCAACGCA -> TTGCAACGCAG
ATTGCAGAGCA -> TTGCAGAGCAG
ATTGGCAAAAC -> TTGGCAAAACT
ATTGGCTGATA -> TTGGCTGATAT
ATTGTGCAGTC -> TTGTGCAGTCT
ATTTAACGCTT -> TTTAACGCTTC
ATTTACTCAGG -> TTTACTCAGGG
ATTTACTCGAA -> TTTACTCGAAG
ATTTAGACATA -> TTTAGACATAT
ATTTATCCGCT -> TTTATCCGCTG
ATTTCGTTGGT -> TTTCGTTGGTG
ATTTGACTAGG -> TTTGACTAGGC
ATTTGTGCCGT -> TTTGTGCCGTA
ATTTTACAGTT -> TTTTACAGTTG
ATTTTGGAAAG -> TTTTGGAAAGC
ATTTTTCTTGC -> TTTTTCTTGCC
CAAAACTCACC -> AAAACTCACCT
CAAAAGTTTTG -> AAAAGTTTTGA
CAAACTAGTTG -> AAACTAGTTGA
CAAATCCGTCA -> AAATCCGTCAG
CAACACATGCT -> AACACATGCTC
CAACACCGAGT -> AACACCGAGTG
CAACATGACAG -> AACATGACAGG
CAACCAGGTAT -> AACCAGGTATA
CAACCTAAGAC -> AACCTAAGACT
CAACGCAGTAT -> AACGCAGTATC
CAACGTACCGG -> AACGTACCGGT
CAACTCAACCA -> AACTCAACCAG
CAAGACTCATC -> AAGACTCATCG
CAAGAGGTCAA -> AAGAGGTCAAG
CAAGCCCATAC -> AAGCCCATACG
CAAGCCTCCTA -> AAGCCTCCTAG
CAAGGCCGAAT -> AAGGCCGAATA
CAAGTAATGCG -> AAGTAATGCGC
CAAGTAGCCCA -> AAGTAGCCCAT
CAAGTTGTCGC -> AAGTTGTCGCT
CAATCCTACAT -> AATCCTACATA
CAATGTAACTA -> AATGTAACTAA
CAATTAATGGT -> AATTAATGGTT
CAATTCGCTGC -> AATTCGCTGCT
CAATTTAGACA -> AATTTAGACAT
CAATTTGACTA -> AATTTGACTAG
CACAAAAGTTT -> ACAAAAGTTTT
CACACATGCCG -> ACACATGCCGC
CACAGAAGGGA -> ACAGAAGGGAT
CACATGCCGCA -> ACATGCCGCAC
CACATGCTCCT -> ACATGCTCCTC
CACATTAGCTA -> ACATTAGCTAA
CACCAAGTAAT -> ACCAAGTAATG
CACCCCGTCTT -> ACCCCGTCTTG
CACCCGAAGTA -> ACCCGAAGTAC
CACCGAGTGCA -> ACCGAGTGCAA
CACCGTGTGCC -> ACCGTGTGCCA
CACCTCCTCGA -> ACCTCCTCGAA
CACCTCTCCTT -> ACCTCTCCTTC
CACGATCCTGA -> ACGATCCTGAG
CACGGCCCGGT -> ACGGCCCGGTC
CACGGCGCAAC -> ACGGCGCAACA
CACGGGAGTTT -> ACGGGAGTTTG
CACGGGATACA -> ACGGGATACAT
CACGTGGCGAA -> ACGTGGCGAAA
CACGTGGGGGT -> ACGTGGGGGTC
CACTACTTTTG -> ACTACTTTTGC
CACTAGTAGGG -> ACTAGTAGGGT
CACTCCAGTTA -> ACTCCAGTTAA
CACTCTCGTCG -> ACTCTCGTCGG
CACTCTGCTGG -> ACTCTGCTGGT
CACTGGAAGAG -> ACTGGAAGAGA
CACTGTCGGAA -> ACTGTCGGAAA
CACTGTGAGTG -> ACTGTGAGTGA
CACTTATCATG -> ACTTATCATGG
CACTTCATAAC -> ACTTCATAACC
CACTTCCCGCC -> ACTTCCCGCCG
CACTTCGTATG -> ACTTCGTATGG
CACTTTACCAG -> ACTTTACCAGG
CACTTTCGACG -> ACTTTCGACGA
CAGAAGGGATC -> AGAAGGGATCG
CAGAAGTACAT -> AGAAGTACATG
CAGACCTGTCT -> AGACCTGTCTA
CAGACGTGAAG -> AGACGTGAAGA
CAGAGCAGGCT -> AGAGCAGGCTA
CAGCAGACCTG -> AGCAGACCTGT
CAGCAGGCCAC -> AGCAGGCCACG
CAGCGTGGTCG -> AGCGTGGTCGG
CAGCTCCTACT -> AGCTCCTACTC
CAGCTGGCACT -> AGCTGGCACTG
CAGGCACTCTC -> AGGCACTCTCG
CAGGCCACGGC -> AGGCCACGGCG
CAGGCTACTGA -> AGGCTACTGAG
CAGGGATCCAT -> AGGGATCCATA
CAGGGTATAGT -> AGGGTATAGTT
CAGGTAACTGG -> AGGTAACTGGG
CAGGTAATCGT -> AGGTAATCGTA
CAGGTATACGT -> AGGTATACGTT
CAGGTCCCACC -> AGGTCCCACCT
CAGTAACAATG -> AGTAACAATGT
CAGTATCCGAA -> AGTATCCGAAG
CAGTATGCTAT -> AGTATGCTATA
CAGTCTGCCTG -> AGTCTGCCTGG
CAGTCTGGTCA -> AGTCTGGTCAT
CAGTTAAGTTA -> AGTTAAGTTAG
CAGTTGTGACA -> AGTTGTGACAC
CATAACCCGGG -> ATAACCCGGGT
CATAAGAATGA -> ATAAGAATGAC
CATAATAAATT -> ATAATAAATTA
CATAATAGTCA -> ATAATAGTCAA
CATACGTGAAT -> ATACGTGAATG
CATACTTAGAA -> ATACTTAGAAG
CATAGCATCTC -> ATAGCATCTCG
CATAGCTCAGC -> ATAGCTCAGCA
CATAGTGTAGC -> ATAGTGTAGCA
CATATGGATCC -> ATATGGATCCT
CATATGTTAGT -> ATATGTTAGTG
CATATTGCAAC -> ATATTGCAACG
CATCACAGAAG -> ATCACAGAAGG
CATCCACTCTG -> ATCCACTCTGC
CATCCCTGTTT -> ATCCCTGTTTT
CATCCGAACAC -> ATCCGAACACA
CATCGCCAATT -> ATCGCCAATTT
CATCGGATATG -> ATCGGATATGT
CATCTCGCTTA -> ATCTCGCTTAT
CATGACAGGTA -> ATGACAGGTAA
CATGACGCTCC -> ATGACGCTCCA
CATGAGGATAC -> ATGAGGATACG
CATGAGTTTGT -> ATGAGTTTGTG
CATGCCAAGTT -> ATGCCAAGTTG
CATGCCAATTT -> ATGCCAATTTA
CATGCCGCACT -> ATGCCGCACTC
CATGCCTAGGA -> ATGCCTAGGAA
CATGCGGGGCC -> ATGCGGGGCCG
CATGCTCCTCT -> ATGCTCCTCTT
CATGGATGATG -> ATGGATGATGC
CATGGTTTATC -> ATGGTTTATCT
CATTAGCTAAA -> ATTAGCTAAAT
CATTATTAAGT -> ATTATTAAGTC
CATTGGCTGAT -> ATTGGCTGATA
CATTTACTCGA -> ATTTACTCGAA
CATTTATCCGC -> ATTTATCCGCT
CATTTTACAGT -> ATTTTACAGTT
CATTTTGGAAA -> ATTTTGGAAAG
CCAAGTAATGC -> CAAGTAATGCG
CCAAGTAGCCC -> CAAGTAGCCCA
CCAAGTTGTCG -> CAAGTTGTCGC
CCAATTTAGAC -> CAATTTAGACA
CCAATTTGACT -> CAATTTGACTA
CCACCGTGTGC -> CACCGTGTGCC
CCACCTCTCCT -> CACCTCTCCTT
CCACGGCGCAA -> CACGGCGCAAC
CCACGGGATAC -> CACGGGATACA
CCACGTGGCGA -> CACGTGGCGAA
CCACGTGGGGG -> CACGTGGGGGT
CCACTCTGCTG -> CACTCTGCTGG
CCACTTCATAA -> CACTTCATAAC
CCAGAAGTACA -> CAGAAGTACAT
CCAGCTGGCAC -> CAGCTGGCACT
CCAGGCACTCT -> CAGGCACTCTC
CCAGGTAATCG -> CAGGTAATCGT
CCAGGTATACG -> CAGGTATACGT
CCAGGTCCCAC -> CAGGTCCCACC
CCAGTAACAAT -> CAGTAACAATG
CCAGTCTGCCT -> CAGTCTGCCTG
CCAGTTAAGTT -> CAGTTAAGTTA
CCATACGTGAA -> CATACGTGAAT
CCATACTTAGA -> CATACTTAGAA
CCATAGCATCT -> CATAGCATCTC
CCATAGCTCAG -> CATAGCTCAGC
CCATAGTGTAG -> CATAGTGTAGC
CCATATGGATC -> CATATGGATCC
CCATCCACTCT -> CATCCACTCTG
CCATCCCTGTT -> CATCCCTGTTT
CCATCCGAACA -> CATCCGAACAC
CCATGACGCTC -> CATGACGCTCC
CCATTATTAAG -> CATTATTAAGT
CCCACCGTGTG -> CCACCGTGTGC
CCCACCTCTCC -> CCACCTCTCCT
CCCAGCTGGCA -> CCAGCTGGCAC
CCCAGTAACAA -> CCAGTAACAAT
CCCAGTCTGCC -> CCAGTCTGCCT
CCCATACGTGA -> CCATACGTGAA
CCCATAGCATC -> CCATAGCATCT
CCCATCCCTGT -> CCATCCCTGTT
CCCATCCGAAC -> CCATCCGAACA
CCCATGACGCT -> CCATGACGCTC
CCCCAGTAACA -> CCCAGTAACAA
CCCCAGTCTGC -> CCCAGTCTGCC
CCCCATAGCAT -> CCCATAGCATC
CCCCATGACGC -> CCCATGACGCT
CCCCGTCTTGT -> CCCGTCTTGTG
CCCCTACGGAT -> CCCTACGGATG
CCCGAAGTACT -> CCGAAGTACTC
CCCGAGTGACG -> CCGAGTGACGT
CCCGATGCCCG -> CCGATGCCCGT
CCCGCAACACA -> CCGCAACACAT
CCCGCCGTTCG -> CCGCCGTTCGA
CCCGGGGAGCC -> CCGGGGAGCCG
CCCGGGTGCCT -> CCGGGTGCCTT
CCCGGTCCTGC -> CCGGTCCTGCA
CCCGTCCGGGA -> CCGTCCGGGAG
CCCGTCTTGTG -> CCGTCTTGTGA
CCCTACGGATG -> CCTACGGATGT
CCCTCTGCTGA -> CCTCTGCTGAT
CCCTGTTTTAG -> CCTGTTTTAGT
CCGAACACATT -> CGAACACATTA
CCGAAGGATCT -> CGAAGGATCTT
CCGAAGTACTC -> CGAAGTACTCG
CCGAAGTGCTC -> CGAAGTGCTCT
CCGAATAAGGA -> CGAATAAGGAC
CCGACACTGTG -> CGACACTGTGA
CCGACCATTAT -> CGACCATTATT
CCGAGTCTTAC -> CGAGTCTTACC
CCGAGTGACGT -> CGAGTGACGTA
CCGAGTGCAAA -> CGAGTGCAAAT
CCGATGCCCGT -> CGATGCCCGTC
CCGCAACACAT -> CGCAACACATG
CCGCACTAGTA -> CGCACTAGTAG
CCGCACTCCAG -> CGCACTCCAGT
CCGCCCACCGT -> CGCCCACCGTG
CCGCCGTTCGA -> CGCCGTTCGAG
CCGCTCAACTC -> CGCTCAACTCA
CCGCTGTTCTC -> CGCTGTTCTCG
CCGGCCTCAAG -> CGGCCTCAAGC
CCGGGAGAGGA -> CGGGAGAGGAG
CCGGGGAGCCG -> CGGGGAGCCGA
CCGGGTGCCTT -> CGGGTGCCTTT
CCGGTCCTGCA -> CGGTCCTGCAG
CCGGTGATGGA -> CGGTGATGGAT
CCGGTGTTACA -> CGGTGTTACAT
CCGTAAAGTTC -> CGTAAAGTTCA
CCGTCAGACGT -> CGTCAGACGTG
CCGTCCACGTG -> CGTCCACGTGG
CCGTCCCGGGG -> CGTCCCGGGGA
CCGTCCGGGAG -> CGTCCGGGAGA
CCGTCTTGTGA -> CGTCTTGTGAT
CCGTGTGAGTG -> CGTGTGAGTGA
CCGTGTGCCAC -> CGTGTGCCACT
CCGTTAGTACA -> CGTTAGTACAC
CCGTTCGAGCC -> CGTTCGAGCCT
CCTAAAGAGGA -> CTAAAGAGGAG
CCTAAGACTTG -> CTAAGACTTGT
CCTAATGATCT -> CTAATGATCTG
CCTACATATTG -> CTACATATTGC
CCTACGGATGT -> CTACGGATGTC
CCTACTCACGG -> CTACTCACGGC
CCTAGCATAAT -> CTAGCATAATA
CCTAGGAATCT -> CTAGGAATCTG
CCTATTGTGCA -> CTATTGTGCAG
CCTCAACGTAC -> CTCAACGTACC
CCTCAAGCCCA -> CTCAAGCCCAT
CCTCCTAGCAT -> CTCCTAGCATA
CCTCCTCGAAG -> CTCCTCGAAGT
CCTCGAAGTTT -> CTCGAAGTTTA
CCTCTCATGAG -> CTCTCATGAGT
CCTCTCCTTCC -> CTCTCCTTCCG
CCTCTGCTGAT -> CTCTGCTGATC
CCTCTTGAGTG -> CTCTTGAGTGC
CCTGAGGTAGG -> CTGAGGTAGGT
CCTGCAAGCCT -> CTGCAAGCCTC
CCTGCAGTATG -> CTGCAGTATGC
CCTGCCCCTAC -> CTGCCCCTACG
CCTGGAGAATA -> CTGGAGAATAT
CCTGGAGGGCC -> CTGGAGGGCCT
CCTGTAGGCTG -> CTGTAGGCTGG
CCTGTCTAAAG -> CTGTCTAAAGA
CCTGTGTAGCG -> CTGTGTAGCGA
CCTGTTTTAGT -> CTGTTTTAGTG
CCTTACTTGGG -> CTTACTTGGGA
CCTTCCGTCCA -> CTTCCGTCCAC
CCTTGACGCGT -> CTTGACGCGTC
CCTTTCCAAGT -> CTTTCCAAGTA
CGAAACTAGAA -> GAAACTAGAAA
CGAAACTGCAC -> GAAACTGCACT
CGAAAGTCATT -> GAAAGTCATTT
CGAACACATTA -> GAACACATTAG
CGAAGCGGAAT -> GAAGCGGAATA
CGAAGGATCTT -> GAAGGATCTTT
CGAAGTACTCG -> GAAGTACTCGT
CGAAGTGCTCT -> GAAGTGCTCTC
CGAAGTTTAGT -> GAAGTTTAGTT
CGAATAAGGAC -> GAATAAGGACC
CGACACTGTGA -> GACACTGTGAG
CGACAGGGATC -> GACAGGGATCC
CGACCATTATT -> GACCATTATTA
CGACCTTACTT -> GACCTTACTTG
CGACGAAACTA -> GACGAAACTAG
CGAGCCTGCCC -> GAGCCTGCCCC
CGAGGTGCGGG -> GAGGTGCGGGT
CGAGTCTTACC -> GAGTCTTACCT
CGAGTGACGTA -> GAGTGACGTAA
CGAGTGCAAAT -> GAGTGCAAATC
CGATACGTTTT -> GATACGTTTTG
CGATCCTGAGG -> GATCCTGAGGT
CGATGCCCGTC -> GATGCCCGTCC
CGCAACACATG -> GCAACACATGC
CGCAACATGAC -> GCAACATGACA
CGCACTAGTAG -> GCACTAGTAGG
CGCACTCCAGT -> GCACTCCAGTT
CGCAGTATCCG -> GCAGTATCCGA
CGCATGAGGAT -> GCATGAGGATA
CGCATTTACTC -> GCATTTACTCG
CGCCAATTTGA -> GCCAATTTGAC
CGCCAGGTCCC -> GCCAGGTCCCA
CGCCCACCGTG -> GCCCACCGTGT
CGCCCGAGTGA -> GCCCGAGTGAC
CGCCCGCAACA -> GCCCGCAACAC
CGCCGTCCCGG -> GCCGTCCCGGG
CGCCGTTCGAG -> GCCGTTCGAGC
CGCGCTAGGCA -> GCGCTAGGCAC
CGCGTCCCCAT -> GCGTCCCCATA
CGCGTTAGGAG -> GCGTTAGGAGA
CGCTAGGCACT -> GCTAGGCACTT
CGCTCAACTCA -> GCTCAACTCAA
CGCTCCAGAAG -> GCTCCAGAAGT
CGCTGCTAAAC -> GCTGCTAAACG
CGCTGGTCCAC -> GCTGGTCCACG
CGCTGTTCTCG -> GCTGTTCTCGC
CGCTTATTTGT -> GCTTATTTGTG
CGCTTCCGACA -> GCTTCCGACAC
CGGAAAGGTTT -> GGAAAGGTTTT
CGGAATAAAAT -> GGAATAAAATT
CGGAGTCCAGG -> GGAGTCCAGGT
CGGATATCCGG -> GGATATCCGGC
CGGATATGTGC -> GGATATGTGCC
CGGATGTCGGA -> GGATGTCGGAG
CGGCCCGGTCC -> GGCCCGGTCCT
CGGCCTCAAGC -> GGCCTCAAGCC
CGGCGCAACAT -> GGCGCAACATG
CGGCGTCAACA -> GGCGTCAACAC
CGGGAGAGGAG -> GGGAGAGGAGA
CGGGAGTTTGC -> GGGAGTTTGCG
CGGGATACATA -> GGGATACATAA
CGGGATATTTT -> GGGATATTTTT
CGGGGAGCCGA -> GGGGAGCCGAC
CGGGGCCGCTC -> GGGGCCGCTCA
CGGGTCCCGAT -> GGGTCCCGATG
CGGGTCGTTAA -> GGGTCGTTAAA
CGGGTGCCTTT -> GGGTGCCTTTC
CGGTACCGTGT -> GGTACCGTGTG
CGGTCCTGCAG -> GGTCCTGCAGT
CGGTGATGGAT -> GGTGATGGATT
CGGTGGATCTA -> GGTGGATCTAC
CGGTGTTACAT -> GGTGTTACATG
CGGTTAAACTT -> GGTTAAACTTA
CGTAAAGTTCA -> GTAAAGTTCAT
CGTAAGAAAAA -> GTAAGAAAAAC
CGTAATGGGTC -> GTAATGGGTCA
CGTACCGGTGA -> GTACCGGTGAT
CGTAGCGCCCG -> GTAGCGCCCGA
CGTAGTTGAAC -> GTAGTTGAACA
CGTATAATGAC -> GTATAATGACA
CGTATGGAAGC -> GTATGGAAGCA
CGTCAACACCG -> GTCAACACCGA
CGTCAGACGTG -> GTCAGACGTGA
CGTCATGCGGG -> GTCATGCGGGG
CGTCCACGTGG -> GTCCACGTGGC
CGTCCCCATAG -> GTCCCCATAGC
CGTCCCGGGGA -> GTCCCGGGGAG
CGTCCGGGAGA -> GTCCGGGAGAG
CGTCCTAAAGA -> GTCCTAAAGAG
CGTCGGGATAT -> GTCGGGATATT
CGTCTTGTGAT -> GTCTTGTGATA
CGTGAAGAAGT -> GTGAAGAAGTT
CGTGAAGTGCC -> GTGAAGTGCCT
CGTGAATGGCC -> GTGAATGGCCC
CGTGGCGAAAG -> GTGGCGAAAGT
CGTGGGGGTCC -> GTGGGGGTCCG
CGTGGGTTCAA -> GTGGGTTCAAT
CGTGGTCGGAT -> GTGGTCGGATA
CGTGTGAGTGA -> GTGTGAGTGAA
CGTGTGCCACT -> GTGTGCCACTT
CGTTAAATTGC -> GTTAAATTGCA
CGTTAGGAGAG -> GTTAGGAGAGC
CGTTAGTACAC -> GTTAGTACACC
CGTTCGAGCCT -> GTTCGAGCCTG
CGTTGGTGGTA -> GTTGGTGGTAA
CGTTTTAGGAT -> GTTTTAGGATT
CGTTTTGTTGC -> GTTTTGTTGCG
CTAAACGGTTA -> TAAACGGTTAA
CTAAAGAGGAG -> TAAAGAGGAGT
CTAAAGAGGTA -> TAAAGAGGTAG
CTAAATATTCT -> TAAATATTCTC
CTAACAGCGTG -> TAACAGCGTGG
CTAAGACTTGT -> TAAGACTTGTA
CTAATGATCTG -> TAATGATCTGG
CTACATATTGC -> TACATATTGCA
CTACATGCCAA -> TACATGCCAAT
CTACGACAGGG -> TACGACAGGGA
CTACGGATGTC -> TACGGATGTCG
CTACGGGTCCC -> TACGGGTCCCG
CTACTACATGC -> TACTACATGCC
CTACTCACGGC -> TACTCACGGCC
CTACTGAGTGC -> TACTGAGTGCC
CTACTTTTGCG -> TACTTTTGCGT
CTAGAAAGTTA -> TAGAAAGTTAA
CTAGCATAATA -> TAGCATAATAA
CTAGCTCACCA -> TAGCTCACCAA
CTAGGAATCTG -> TAGGAATCTGA
CTAGGCACTTC -> TAGGCACTTCC
CTAGGCGTCAT -> TAGGCGTCATG
CTAGTAGGGTG -> TAGTAGGGTGC
CTAGTTGAGCC -> TAGTTGAGCCT
CTATACCGCAC -> TATACCGCACT
CTATCGGCGTC -> TATCGGCGTCA
CTATTATTAGA -> TATTATTAGAC
CTATTGTGCAG -> TATTGTGCAGT
CTCAACCAGGT -> TCAACCAGGTA
CTCAACGTACC -> TCAACGTACCG
CTCAACTCAAC -> TCAACTCAACC
CTCAAGCCCAT -> TCAAGCCCATA
CTCACCAAGTA -> TCACCAAGTAA
CTCACCTCCTC -> TCACCTCCTCG
CTCACGGCCCG -> TCACGGCCCGG
CTCAGCAGACC -> TCAGCAGACCT
CTCAGGGTATA -> TCAGGGTATAG
CTCATCGGATA -> TCATCGGATAT
CTCATGAGTTT -> TCATGAGTTTG
CTCCAGAAGTA -> TCCAGAAGTAC
CTCCAGTTAAG -> TCCAGTTAAGT
CTCCTACTCAC -> TCCTACTCACG
CTCCTAGCATA -> TCCTAGCATAA
CTCCTCGAAGT -> TCCTCGAAGTT
CTCCTCTTGAG -> TCCTCTTGAGT
CTCCTGTGTAG -> TCCTGTGTAGC
CTCCTTCCGTC -> TCCTTCCGTCC
CTCGAAGCGGA -> TCGAAGCGGAA
CTCGAAGTTTA -> TCGAAGTTTAG
CTCGCCCGCAA -> TCGCCCGCAAC
CTCGCGTTAGG -> TCGCGTTAGGA
CTCGCTTATTT -> TCGCTTATTTG
CTCGTCGGGAT -> TCGTCGGGATA
CTCGTGGGTTC -> TCGTGGGTTCA
CTCTACTACAT -> TCTACTACATG
CTCTCATGAGT -> TCTCATGAGTT
CTCTCCTGTGT -> TCTCCTGTGTA
CTCTCCTTCCG -> TCTCCTTCCGT
CTCTCGTCGGG -> TCTCGTCGGGA
CTCTCTCTTGG -> TCTCTCTTGGC
CTCTCTTGGCA -> TCTCTTGGCAA
CTCTGCTGATC -> TCTGCTGATCC
CTCTGCTGGTT -> TCTGCTGGTTA
CTCTTGAGTGC -> TCTTGAGTGCA
CTCTTGGCAAG -> TCTTGGCAAGA
CTGAGGAATCC -> TGAGGAATCCA
CTGAGGTAGGT -> TGAGGTAGGTG
CTGAGTGCCCC -> TGAGTGCCCCA
CTGATATAACG -> TGATATAACGC
CTGATCCCATC -> TGATCCCATCC
CTGCAAGCCTC -> TGCAAGCCTCC
CTGCAATTAAT -> TGCAATTAATG
CTGCACTTATC -> TGCACTTATCA
CTGCAGTATGC -> TGCAGTATGCT
CTGCCCCTACG -> TGCCCCTACGG
CTGCCTGGAGG -> TGCCTGGAGGG
CTGCTAAACGG -> TGCTAAACGGT
CTGCTGATCCC -> TGCTGATCCCA
CTGCTGGTTAT -> TGCTGGTTATT
CTGGAAGAGAG -> TGGAAGAGAGT
CTGGAGAATAT -> TGGAGAATATA
CTGGAGGGCCT -> TGGAGGGCCTC
CTGGCACTGTC -> TGGCACTGTCG
CTGGGAACGGT -> TGGGAACGGTA
CTGGGCCGAAG -> TGGGCCGAAGG
CTGGGTTCTAT -> TGGGTTCTATT
CTGGTCATCAC -> TGGTCATCACA
CTGGTCCACGG -> TGGTCCACGGG
CTGGTTATTGG -> TGGTTATTGGC
CTGTAGGCTGG -> TGTAGGCTGGG
CTGTCCCCAGT -> TGTCCCCAGTC
CTGTCGGAAAG -> TGTCGGAAAGG
CTGTCTAAAGA -> TGTCTAAAGAG
CTGTGAGTGAA -> TGTGAGTGAAG
CTGTGTAGCGA -> TGTGTAGCGAA
CTGTTCTCGCG -> TGTTCTCGCGT
CTGTTTTAGTG -> TGTTTTAGTGC
CTTACAACCTA -> TTACAACCTAA
CTTACCTGTAG -> TTACCTGTAGG
CTTACTTGGGA -> TTACTTGGGAG
CTTAGAAGAGC -> TTAGAAGAGCA
CTTATCATGGT -> TTATCATGGTT
CTTATCCATCC -> TTATCCATCCA
CTTATTTGTGC -> TTATTTGTGCC
CTTCATAACCC -> TTCATAACCCG
CTTCCCGCCGT -> TTCCCGCCGTT
CTTCCGACACT -> TTCCGACACTG
CTTCCGCCCAC -> TTCCGCCCACC
CTTCCGTCCAC -> TTCCGTCCACG
CTTCGTATGGA -> TTCGTATGGAA
CTTGACGCGTC -> TTGACGCGTCC
CTTGAGTGCAT -> TTGAGTGCATT
CTTGCCATAGC -> TTGCCATAGCT
CTTGGCAAGAG -> TTGGCAAGAGG
CTTGGGAGCGA -> TTGGGAGCGAG
CTTGTATCAGC -> TTGTATCAGCA
CTTGTGATAGG -> TTGTGATAGGC
CTTTACCAGGC -> TTTACCAGGCA
CTTTCCAAGTA -> TTTCCAAGTAG
CTTTCGACGAA -> TTTCGACGAAA
CTTTCGGTGGA -> TTTCGGTGGAT
CTTTTGCGTCC -> TTTTGCGTCCT
GAAAAACCACG -> AAAAACCACGT
GAAACTAGAAA -> AAACTAGAAAG
GAAACTGCACT -> AAACTGCACTT
GAAAGCACCCG -> AAAGCACCCGA
GAAAGGTTTTG -> AAAGGTTTTGC
GAAAGTCATTT -> AAAGTCATTTT
GAAAGTTAATC -> AAAGTTAATCC
GAACACATTAG -> AACACATTAGC
GAACACTGGAA -> AACACTGGAAG
GAACAGCTCCT -> AACAGCTCCTA
GAACGGTACCG -> AACGGTACCGT
GAAGAAGTTAG -> AAGAAGTTAGA
GAAGAATCGAT -> AAGAATCGATA
GAAGACACACA -> AAGACACACAT
GAAGAGAGTAC -> AAGAGAGTACA
GAAGAGCACTT -> AAGAGCACTTC
GAAGCACTTTC -> AAGCACTTTCG
GAAGCGGAATA -> AAGCGGAATAA
GAAGGATCTTT -> AAGGATCTTTC
GAAGGGATCGC -> AAGGGATCGCA
GAAGTACATGC -> AAGTACATGCC
GAAGTACTCGT -> AAGTACTCGTG
GAAGTGCCTGC -> AAGTGCCTGCA
GAAGTGCTCTC -> AAGTGCTCTCC
GAAGTTAGATT -> AAGTTAGATTA
GAAGTTTAGTT -> AAGTTTAGTTG
GAATAAAATTT -> AATAAAATTTC
GAATAAGGACC -> AATAAGGACCC
GAATATACTAC -> AATATACTACG
GAATCCATATG -> AATCCATATGG
GAATCGATACG -> AATCGATACGT
GAATCTGAGGA -> AATCTGAGGAA
GAATGACGACC -> AATGACGACCT
GAATGGCCCAG -> AATGGCCCAGC
GAATTTAACGC -> AATTTAACGCT
GACAAGACTCA -> ACAAGACTCAT
GACACACATGC -> ACACACATGCC
GACACTGTGAG -> ACACTGTGAGT
GACACTTTACC -> ACACTTTACCA
GACAGGGATCC -> ACAGGGATCCA
GACAGGTAACT -> ACAGGTAACTG
GACATAATAGT -> ACATAATAGTC
GACATATGTTA -> ACATATGTTAG
GACCATTATTA -> ACCATTATTAA
GACCCCAGTAA -> ACCCCAGTAAC
GACCTGTCTAA -> ACCTGTCTAAA
GACCTTACTTG -> ACCTTACTTGG
GACGAAACTAG -> ACGAAACTAGA
GACGACCTTAC -> ACGACCTTACT
GACGCGTCCCC -> ACGCGTCCCCA
GACGCTCCAGA -> ACGCTCCAGAA
GACGTAAGAAA -> ACGTAAGAAAA
GACGTGAAGAA -> ACGTGAAGAAG
GACTAGCTCAC -> ACTAGCTCACC
GACTAGGCGTC -> ACTAGGCGTCA
GACTCATCGGA -> ACTCATCGGAT
GACTGCAATTA -> ACTGCAATTAA
GACTGTCCCCA -> ACTGTCCCCAG
GACTTGTATCA -> ACTTGTATCAG
GAGAATATACT -> AGAATATACTA
GAGACTGCAAT -> AGACTGCAATT
GAGAGACTGCA -> AGAGACTGCAA
GAGAGAGACTG -> AGAGAGACTGC
GAGAGCATGCC -> AGAGCATGCCA
GAGAGGAGATC -> AGAGGAGATCT
GAGAGTACACG -> AGAGTACACGA
GAGATCTCTAC -> AGATCTCTACT
GAGCACTTCGT -> AGCACTTCGTA
GAGCAGGCTAC -> AGCAGGCTACT
GAGCATGCCAA -> AGCATGCCAAG
GAGCCGACCAT -> AGCCGACCATT
GAGCCTGCCCC -> AGCCTGCCCCT
GAGCCTGGAGA -> AGCCTGGAGAA
GAGCGAGGTGC -> AGCGAGGTGCG
GAGGAATCCAT -> AGGAATCCATA
GAGGAGATCTC -> AGGAGATCTCT
GAGGAGTGTCA -> AGGAGTGTCAC
GAGGATACGCC -> AGGATACGCCA
GAGGGCCTCTC -> AGGGCCTCTCA
GAGGTAGAACA -> AGGTAGAACAC
GAGGTAGGTGC -> AGGTAGGTGCT
GAGGTCAAGGC -> AGGTCAAGGCC
GAGGTGCGGGT -> AGGTGCGGGTC
GAGTACACGAT -> AGTACACGATC
GAGTCCAGGTA -> AGTCCAGGTAA
GAGTCTTACCT -> AGTCTTACCTG
GAGTGAAGAAT -> AGTGAAGAATC
GAGTGAAGACA -> AGTGAAGACAC
GAGTGACGTAA -> AGTGACGTAAG
GAGTGCAAATC -> AGTGCAAATCC
GAGTGCATTTT -> AGTGCATTTTA
GAGTGCCCCAT -> AGTGCCCCATG
GAGTGTCACGG -> AGTGTCACGGG
GAGTTACGTGA -> AGTTACGTGAA
GAGTTTGCGTA -> AGTTTGCGTAT
GAGTTTGTGGT -> AGTTTGTGGTG
GATACATAAGA -> ATACATAAGAA
GATACGCCAGG -> ATACGCCAGGT
GATACGTTTTG -> ATACGTTTTGT
GATAGGCATCG -> ATAGGCATCGC
GATATAACGCA -> ATATAACGCAT
GATATCCGGCC -> ATATCCGGCCT
GATATGTGCCA -> ATATGTGCCAT
GATATTTTTCT -> ATATTTTTCTT
GATCCATACTT -> ATCCATACTTA
GATCCCATCCC -> ATCCCATCCCT
GATCCTATTGT -> ATCCTATTGTG
GATCCTGAGGT -> ATCCTGAGGTA
GATCGCATTTA -> ATCGCATTTAC
GATCTACGACA -> ATCTACGACAG
GATCTCTACTA -> ATCTCTACTAC
GATCTGGGCCG -> ATCTGGGCCGA
GATCTTTCGGT -> ATCTTTCGGTG
GATGATGCGTA -> ATGATGCGTAA
GATGCCCGTCC -> ATGCCCGTCCG
GATGCGTAATG -> ATGCGTAATGG
GATGGATTTAC -> ATGGATTTACT
GATGTCGGAGT -> ATGTCGGAGTC
GATTACGTAGC -> ATTACGTAGCG
GATTATCCCTC -> ATTATCCCTCT
GATTTACTCAG -> ATTTACTCAGG
GCAAAACTCAC -> CAAAACTCACC
GCAAATCCGTC -> CAAATCCGTCA
GCAACACATGC -> CAACACATGCT
GCAACATGACA -> CAACATGACAG
GCAACGCAGTA -> CAACGCAGTAT
GCAAGAGGTCA -> CAAGAGGTCAA
GCAAGCCTCCT -> CAAGCCTCCTA
GCAATCCTACA -> CAATCCTACAT
GCAATTAATGG -> CAATTAATGGT
GCACCCGAAGT -> CACCCGAAGTA
GCACTAGTAGG -> CACTAGTAGGG
GCACTCCAGTT -> CACTCCAGTTA
GCACTCTCGTC -> CACTCTCGTCG
GCACTGTCGGA -> CACTGTCGGAA
GCACTTATCAT -> CACTTATCATG
GCACTTCCCGC -> CACTTCCCGCC
GCACTTCGTAT -> CACTTCGTATG
GCACTTTCGAC -> CACTTTCGACG
GCAGACCTGTC -> CAGACCTGTCT
GCAGAGCAGGC -> CAGAGCAGGCT
GCAGGCCACGG -> CAGGCCACGGC
GCAGGCTACTG -> CAGGCTACTGA
GCAGTATCCGA -> CAGTATCCGAA
GCAGTATGCTA -> CAGTATGCTAT
GCAGTCTGGTC -> CAGTCTGGTCA
GCATAATAAAT -> CATAATAAATT
GCATCGCCAAT -> CATCGCCAATT
GCATCTCGCTT -> CATCTCGCTTA
GCATGAGGATA -> CATGAGGATAC
GCATGCCAAGT -> CATGCCAAGTT
GCATTTACTCG -> CATTTACTCGA
GCATTTTACAG -> CATTTTACAGT
GCCAAGTTGTC -> CCAAGTTGTCG
GCCAATTTAGA -> CCAATTTAGAC
GCCAATTTGAC -> CCAATTTGACT
GCCACGGCGCA -> CCACGGCGCAA
GCCACTTCATA -> CCACTTCATAA
GCCAGGTCCCA -> CCAGGTCCCAC
GCCATAGCTCA -> CCATAGCTCAG
GCCATAGTGTA -> CCATAGTGTAG
GCCCACCGTGT -> CCCACCGTGTG
GCCCAGCTGGC -> CCCAGCTGGCA
GCCCATACGTG -> CCCATACGTGA
GCCCATCCGAA -> CCCATCCGAAC
GCCCCATGACG -> CCCCATGACGC
GCCCCTACGGA -> CCCCTACGGAT
GCCCGAGTGAC -> CCCGAGTGACG
GCCCGCAACAC -> CCCGCAACACA
GCCCGGTCCTG -> CCCGGTCCTGC
GCCCGTCCGGG -> CCCGTCCGGGA
GCCGAAGGATC -> CCGAAGGATCT
GCCGAATAAGG -> CCGAATAAGGA
GCCGACCATTA -> CCGACCATTAT
GCCGCACTCCA -> CCGCACTCCAG
GCCGCTCAACT -> CCGCTCAACTC
GCCGGTGTTAC -> CCGGTGTTACA
GCCGTAAAGTT -> CCGTAAAGTTC
GCCGTCCCGGG -> CCGTCCCGGGG
GCCGTTCGAGC -> CCGTTCGAGCC
GCCTAATGATC -> CCTAATGATCT
GCCTAGGAATC -> CCTAGGAATCT
GCCTCAACGTA -> CCTCAACGTAC
GCCTCAAGCCC -> CCTCAAGCCCA
GCCTCCTAGCA -> CCTCCTAGCAT
GCCTCTCATGA -> CCTCTCATGAG
GCCTGCAAGCC -> CCTGCAAGCCT
GCCTGCCCCTA -> CCTGCCCCTAC
GCCTGGAGAAT -> CCTGGAGAATA
GCCTGGAGGGC -> CCTGGAGGGCC
GCCTTGACGCG -> CCTTGACGCGT
GCCTTTCCAAG -> CCTTTCCAAGT
GCGAAACTGCA -> CGAAACTGCAC
GCGAAAGTCAT -> CGAAAGTCATT
GCGAGGTGCGG -> CGAGGTGCGGG
GCGCAACATGA -> CGCAACATGAC
GCGCCCGAGTG -> CGCCCGAGTGA
GCGCCGTCCCG -> CGCCGTCCCGG
GCGCGCTAGGC -> CGCGCTAGGCA
GCGCTAGGCAC -> CGCTAGGCACT
GCGGAATAAAA -> CGGAATAAAAT
GCGGGGCCGCT -> CGGGGCCGCTC
GCGGGTCGTTA -> CGGGTCGTTAA
GCGTAATGGGT -> CGTAATGGGTC
GCGTATAATGA -> CGTATAATGAC
GCGTCAACACC -> CGTCAACACCG
GCGTCATGCGG -> CGTCATGCGGG
GCGTCCCCATA -> CGTCCCCATAG
GCGTCCTAAAG -> CGTCCTAAAGA
GCGTGGTCGGA -> CGTGGTCGGAT
GCGTTAGGAGA -> CGTTAGGAGAG
GCTAAACGGTT -> CTAAACGGTTA
GCTAAATATTC -> CTAAATATTCT
GCTACTGAGTG -> CTACTGAGTGC
GCTAGGCACTT -> CTAGGCACTTC
GCTATACCGCA -> CTATACCGCAC
GCTATCGGCGT -> CTATCGGCGTC
GCTCAACTCAA -> CTCAACTCAAC
GCTCACCAAGT -> CTCACCAAGTA
GCTCAGCAGAC -> CTCAGCAGACC
GCTCCAGAAGT -> CTCCAGAAGTA
GCTCCTACTCA -> CTCCTACTCAC
GCTCCTCTTGA -> CTCCTCTTGAG
GCTCTCCTGTG -> CTCTCCTGTGT
GCTGATATAAC -> CTGATATAACG
GCTGATCCCAT -> CTGATCCCATC
GCTGCTAAACG -> CTGCTAAACGG
GCTGGCACTGT -> CTGGCACTGTC
GCTGGGTTCTA -> CTGGGTTCTAT
GCTGGTCCACG -> CTGGTCCACGG
GCTGGTTATTG -> CTGGTTATTGG
GCTGTTCTCGC -> CTGTTCTCGCG
GCTTACAACCT -> CTTACAACCTA
GCTTATTTGTG -> CTTATTTGTGC
GCTTCCGACAC -> CTTCCGACACT
GCTTCCGCCCA -> CTTCCGCCCAC
GGAAAGCACCC -> GAAAGCACCCG
GGAAAGGTTTT -> GAAAGGTTTTG
GGAACGGTACC -> GAACGGTACCG
GGAAGAGAGTA -> GAAGAGAGTAC
GGAAGCACTTT -> GAAGCACTTTC
GGAATAAAATT -> GAATAAAATTT
GGAATCCATAT -> GAATCCATATG
GGAATCTGAGG -> GAATCTGAGGA
GGACCCCAGTA -> GACCCCAGTAA
GGACTAGCTCA -> GACTAGCTCAC
GGAGAATATAC -> GAGAATATACT
GGAGAGCATGC -> GAGAGCATGCC
GGAGAGGAGAT -> GAGAGGAGATC
GGAGATCTCTA -> GAGATCTCTAC
GGAGCCGACCA -> GAGCCGACCAT
GGAGCGAGGTG -> GAGCGAGGTGC
GGAGGGCCTCT -> GAGGGCCTCTC
GGAGTCCAGGT -> GAGTCCAGGTA
GGAGTGTCACG -> GAGTGTCACGG
GGAGTTTGCGT -> GAGTTTGCGTA
GGATACATAAG -> GATACATAAGA
GGATACGCCAG -> GATACGCCAGG
GGATATCCGGC -> GATATCCGGCC
GGATATGTGCC -> GATATGTGCCA
GGATATTTTTC -> GATATTTTTCT
GGATCCATACT -> GATCCATACTT
GGATCCTATTG -> GATCCTATTGT
GGATCGCATTT -> GATCGCATTTA
GGATCTACGAC -> GATCTACGACA
GGATCTTTCGG -> GATCTTTCGGT
GGATGATGCGT -> GATGATGCGTA
GGATGTCGGAG -> GATGTCGGAGT
GGATTACGTAG -> GATTACGTAGC
GGATTTACTCA -> GATTTACTCAG
GGCAAAACTCA -> GCAAAACTCAC
GGCAAGAGGTC -> GCAAGAGGTCA
GGCACTCTCGT -> GCACTCTCGTC
GGCACTGTCGG -> GCACTGTCGGA
GGCACTTCCCG -> GCACTTCCCGC
GGCATCGCCAA -> GCATCGCCAAT
GGCCACGGCGC -> GCCACGGCGCA
GGCCCAGCTGG -> GCCCAGCTGGC
GGCCCGGTCCT -> GCCCGGTCCTG
GGCCGAAGGAT -> GCCGAAGGATC
GGCCGAATAAG -> GCCGAATAAGG
GGCCGCTCAAC -> GCCGCTCAACT
GGCCTCAAGCC -> GCCTCAAGCCC
GGCCTCTCATG -> GCCTCTCATGA
GGCGAAAGTCA -> GCGAAAGTCAT
GGCGCAACATG -> GCGCAACATGA
GGCGTCAACAC -> GCGTCAACACC
GGCGTCATGCG -> GCGTCATGCGG
GGCTACTGAGT -> GCTACTGAGTG
GGCTGATATAA -> GCTGATATAAC
GGCTGGGTTCT -> GCTGGGTTCTA
GGGAACGGTAC -> GGAACGGTACC
GGGAGAGGAGA -> GGAGAGGAGAT
GGGAGCCGACC -> GGAGCCGACCA
GGGAGCGAGGT -> GGAGCGAGGTG
GGGAGTTTGCG -> GGAGTTTGCGT
GGGATACATAA -> GGATACATAAG
GGGATATTTTT -> GGATATTTTTC
GGGATCCATAC -> GGATCCATACT
GGGATCGCATT -> GGATCGCATTT
GGGCCGAAGGA -> GGCCGAAGGAT
GGGCCGCTCAA -> GGCCGCTCAAC
GGGCCTCTCAT -> GGCCTCTCATG
GGGGAGCCGAC -> GGGAGCCGACC
GGGGCCGCTCA -> GGGCCGCTCAA
GGGGGTCCGAG -> GGGGTCCGAGT
GGGGTCCGAGT -> GGGTCCGAGTC
GGGTATAGTTT -> GGTATAGTTTT
GGGTCAAACTA -> GGTCAAACTAG
GGGTCCCGATG -> GGTCCCGATGC
GGGTCCGAGTC -> GGTCCGAGTCT
GGGTCGTTAAA -> GGTCGTTAAAT
GGGTGCCGGTG -> GGTGCCGGTGT
GGGTGCCTTTC -> GGTGCCTTTCC
GGGTTCAATGT -> GGTTCAATGTA
GGGTTCTATTA -> GGTTCTATTAT
GGTAACTGGGA -> GTAACTGGGAA
GGTAATAATGC -> GTAATAATGCC
GGTAATCGTAG -> GTAATCGTAGT
GGTACCGTGTG -> GTACCGTGTGA
GGTAGAACACT -> GTAGAACACTG
GGTAGGTGCTT -> GTAGGTGCTTC
GGTATACGTTT -> GTATACGTTTT
GGTATAGTTTT -> GTATAGTTTTT
GGTCAAACTAG -> GTCAAACTAGT
GGTCAAGGCCG -> GTCAAGGCCGA
GGTCATCACAG -> GTCATCACAGA
GGTCCACGGGA -> GTCCACGGGAT
GGTCCCACCTC -> GTCCCACCTCT
GGTCCCGATGC -> GTCCCGATGCC
GGTCCGAGTCT -> GTCCGAGTCTT
GGTCCTGCAGT -> GTCCTGCAGTA
GGTCGGATATC -> GTCGGATATCC
GGTCGTTAAAT -> GTCGTTAAATT
GGTGATGGATT -> GTGATGGATTT
GGTGCCGGTGT -> GTGCCGGTGTT
GGTGCCTTTCC -> GTGCCTTTCCA
GGTGCGGGTCG -> GTGCGGGTCGT
GGTGCTTCCGC -> GTGCTTCCGCC
GGTGGATCTAC -> GTGGATCTACG
GGTGGTAATAA -> GTGGTAATAAT
GGTGTTACATG -> GTGTTACATGG
GGTGTTTAAGT -> GTGTTTAAGTA
GGTTAAACTTA -> GTTAAACTTAT
GGTTATTGGCA -> GTTATTGGCAA
GGTTCTATTAT -> GTTCTATTATT
GGTTTACATTG -> GTTTACATTGG
GGTTTATCTCG -> GTTTATCTCGC
GGTTTTGCCTA -> GTTTTGCCTAA
GTAAAGTTCAT -> TAAAGTTCATT
GTAACAATGTA -> TAACAATGTAA
GTAACTAACAG -> TAACTAACAGC
GTAACTGGGAA -> TAACTGGGAAC
GTAAGAAAAAC -> TAAGAAAAACC
GTAAGCTATCG -> TAAGCTATCGG
GTAATAATGCC -> TAATAATGCCT
GTAATCGTAGT -> TAATCGTAGTT
GTAATGCGCCG -> TAATGCGCCGT
GTAATGGGTCA -> TAATGGGTCAA
GTACACCCCGT -> TACACCCCGTC
GTACACGATCC -> TACACGATCCT
GTACATGCCTA -> TACATGCCTAG
GTACCGGTGAT -> TACCGGTGATG
GTACCGTGTGA -> TACCGTGTGAG
GTACTCGTGGG -> TACTCGTGGGT
GTAGAACACTG -> TAGAACACTGG
GTAGCAATCCT -> TAGCAATCCTA
GTAGCCCATCC -> TAGCCCATCCG
GTAGCGAAACT -> TAGCGAAACTG
GTAGCGCCCGA -> TAGCGCCCGAG
GTAGGCTGGGT -> TAGGCTGGGTT
GTAGGGTGCCG -> TAGGGTGCCGG
GTAGGTGCTTC -> TAGGTGCTTCC
GTAGTTGAACA -> TAGTTGAACAG
GTATAATGACA -> TATAATGACAA
GTATACGTTTT -> TATACGTTTTA
GTATAGTTTTT -> TATAGTTTTTT
GTATCAGCAGG -> TATCAGCAGGC
GTATCCGAAGT -> TATCCGAAGTG
GTATGCTATAC -> TATGCTATACC
GTATGGAAGCA -> TATGGAAGCAC
GTCAAACTAGT -> TCAAACTAGTT
GTCAACACCGA -> TCAACACCGAG
GTCAAGGCCGA -> TCAAGGCCGAA
GTCAATTCGCT -> TCAATTCGCTG
GTCACAAAAGT -> TCACAAAAGTT
GTCACGGGAGT -> TCACGGGAGTT
GTCACTACTTT -> TCACTACTTTT
GTCAGACGTGA -> TCAGACGTGAA
GTCATCACAGA -> TCATCACAGAA
GTCATGCGGGG -> TCATGCGGGGC
GTCATTTTGGA -> TCATTTTGGAA
GTCCACGGGAT -> TCCACGGGATA
GTCCACGTGGC -> TCCACGTGGCG
GTCCAGGTAAT -> TCCAGGTAATC
GTCCCACCTCT -> TCCCACCTCTC
GTCCCCAGTCT -> TCCCCAGTCTG
GTCCCCATAGC -> TCCCCATAGCA
GTCCCGATGCC -> TCCCGATGCCC
GTCCCGGGGAG -> TCCCGGGGAGC
GTCCGAGTCTT -> TCCGAGTCTTA
GTCCGGGAGAG -> TCCGGGAGAGG
GTCCTAAAGAG -> TCCTAAAGAGG
GTCCTGCAGTA -> TCCTGCAGTAT
GTCGCTGGTCC -> TCGCTGGTCCA
GTCGGAAAGGT -> TCGGAAAGGTT
GTCGGAGTCCA -> TCGGAGTCCAG
GTCGGATATCC -> TCGGATATCCG
GTCGGGATATT -> TCGGGATATTT
GTCGTTAAATT -> TCGTTAAATTG
GTCTAAAGAGG -> TCTAAAGAGGT
GTCTGCCTGGA -> TCTGCCTGGAG
GTCTGGTCATC -> TCTGGTCATCA
GTCTTACCTGT -> TCTTACCTGTA
GTCTTGTGATA -> TCTTGTGATAG
GTGAAGAAGTT -> TGAAGAAGTTA
GTGAAGAATCG -> TGAAGAATCGA
GTGAAGACACA -> TGAAGACACAC
GTGAAGTGCCT -> TGAAGTGCCTG
GTGAATGGCCC -> TGAATGGCCCA
GTGACACTTTA -> TGACACTTTAC
GTGACGTAAGA -> TGACGTAAGAA
GTGAGTGAAGA -> TGAGTGAAGAA,TGAGTGAAGAC
GTGATAGGCAT -> TGATAGGCATC
GTGATGGATTT -> TGATGGATTTA
GTGCAAATCCG -> TGCAAATCCGT
GTGCAGTCTGG -> TGCAGTCTGGT
GTGCATTTTAC -> TGCATTTTACA
GTGCCACTTCA -> TGCCACTTCAT
GTGCCATAGTG -> TGCCATAGTGT
GTGCCCCATGA -> TGCCCCATGAC
GTGCCGGTGTT -> TGCCGGTGTTA
GTGCCGTAAAG -> TGCCGTAAAGT
GTGCCTGCAAG -> TGCCTGCAAGC
GTGCCTTGACG -> TGCCTTGACGC
GTGCCTTTCCA -> TGCCTTTCCAA
GTGCGGGTCGT -> TGCGGGTCGTT
GTGCTCTCCTG -> TGCTCTCCTGT
GTGCTTCCGCC -> TGCTTCCGCCC
GTGGACTAGCT -> TGGACTAGCTC
GTGGATCTACG -> TGGATCTACGA
GTGGCGAAAGT -> TGGCGAAAGTC
GTGGGGGTCCG -> TGGGGGTCCGA
GTGGGTTCAAT -> TGGGTTCAATG
GTGGTAATAAT -> TGGTAATAATG
GTGGTCGGATA -> TGGTCGGATAT
GTGGTGTTTAA -> TGGTGTTTAAG
GTGTAGCAATC -> TGTAGCAATCC
GTGTAGCGAAA -> TGTAGCGAAAC
GTGTCACGGGA -> TGTCACGGGAG
GTGTCACTACT -> TGTCACTACTT
GTGTGAGTGAA -> TGTGAGTGAAG
GTGTGCCACTT -> TGTGCCACTTC
GTGTTACATGG -> TGTTACATGGA
GTGTTTAAGTA -> TGTTTAAGTAA
GTTAAACTTAT -> TTAAACTTATC
GTTAAATTGCA -> TTAAATTGCAG
GTTAAGTTAGT -> TTAAGTTAGTG
GTTAATCCGTT -> TTAATCCGTTA
GTTACATGGAT -> TTACATGGATG
GTTACGTGAAG -> TTACGTGAAGT
GTTAGATTATC -> TTAGATTATCC
GTTAGGAGAGC -> TTAGGAGAGCA
GTTAGTACACC -> TTAGTACACCC
GTTAGTGGACT -> TTAGTGGACTA
GTTAGTGTCAC -> TTAGTGTCACT
GTTATTGGCAA -> TTATTGGCAAA
GTTCATTTATC -> TTCATTTATCC
GTTCGAGCCTG -> TTCGAGCCTGC
GTTCTATTATT -> TTCTATTATTA
GTTCTCGCGTT -> TTCTCGCGTTA
GTTGAACAGCT -> TTGAACAGCTC
GTTGAGCCTGG -> TTGAGCCTGGA
GTTGCGCGCTA -> TTGCGCGCTAG
GTTGCTTACAA -> TTGCTTACAAC
GTTGGTGGTAA -> TTGGTGGTAAT
GTTGTCGCTGG -> TTGTCGCTGGT
GTTGTGACACT -> TTGTGACACTT
GTTTAAGTAAG -> TTTAAGTAAGC
GTTTACATTGG -> TTTACATTGGC
GTTTAGTTGCT -> TTTAGTTGCTT
GTTTATCTCGC -> TTTATCTCGCC
GTTTGCGTATA -> TTTGCGTATAA
GTTTGTGGTGT -> TTTGTGGTGTT
GTTTTAGGATT -> TTTTAGGATTA
GTTTTAGTGCC -> TTTTAGTGCCT
GTTTTGAGAGA -> TTTTGAGAGAG
GTTTTGCCTAA -> TTTTGCCTAAT
GTTTTGTTGCG -> TTTTGTTGCGC
GTTTTTTGAAT -> TTTTTTGAATT
TAAAATTTCGT -> AAAATTTCGTT
TAAACGGTTAA -> AAACGGTTAAA
TAAACTTATCC -> AAACTTATCCA
TAAAGAGGAGT -> AAAGAGGAGTG
TAAAGAGGTAG -> AAAGAGGTAGA
TAAAGTTCATT -> AAAGTTCATTT
TAAATATTCTC -> AAATATTCTCT
TAAATTATGAC -> AAATTATGACA
TAAATTGCAGA -> AAATTGCAGAG
TAACAATGTAA -> AACAATGTAAC
TAACAGCGTGG -> AACAGCGTGGT
TAACCCGGGTG -> AACCCGGGTGC
TAACGCATGAG -> AACGCATGAGG
TAACGCTTCCG -> AACGCTTCCGA
TAACTAACAGC -> AACTAACAGCG
TAACTGGGAAC -> AACTGGGAACG
TAAGAAAAACC -> AAGAAAAACCA
TAAGAATGACG -> AAGAATGACGA
TAAGACTTGTA -> AAGACTTGTAT
TAAGCTATCGG -> AAGCTATCGGC
TAAGGACCCCA -> AAGGACCCCAG
TAAGTAAGCTA -> AAGTAAGCTAT
TAAGTCACAAA -> AAGTCACAAAA
TAAGTTAGTGG -> AAGTTAGTGGA
TAATAAATTAT -> AATAAATTATG
TAATAATGCCT -> AATAATGCCTC
TAATAGTCAAT -> AATAGTCAATT
TAATCCGTTAG -> AATCCGTTAGT
TAATCGTAGTT -> AATCGTAGTTG
TAATGACAAGA -> AATGACAAGAC
TAATGATCTGG -> AATGATCTGGG
TAATGCCTCAA -> AATGCCTCAAC
TAATGCGCCGT -> AATGCGCCGTC
TAATGGGTCAA -> AATGGGTCAAA
TAATGGTTTAC -> AATGGTTTACA
TACAACCTAAG -> ACAACCTAAGA
TACACCCCGTC -> ACACCCCGTCT
TACACGATCCT -> ACACGATCCTG
TACAGTTGTGA -> ACAGTTGTGAC
TACATAAGAAT -> ACATAAGAATG
TACATATTGCA -> ACATATTGCAA
TACATGCCAAT -> ACATGCCAATT
TACATGCCTAG -> ACATGCCTAGG
TACATGGATGA -> ACATGGATGAT
TACATTGGCTG -> ACATTGGCTGA
TACCAGGCACT -> ACCAGGCACTC
TACCGCACTAG -> ACCGCACTAGT
TACCGGTGATG -> ACCGGTGATGG
TACCGTGTGAG -> ACCGTGTGAGT
TACCTGTAGGC -> ACCTGTAGGCT
TACGACAGGGA -> ACGACAGGGAT
TACGCCAGGTC -> ACGCCAGGTCC
TACGGATGTCG -> ACGGATGTCGG
TACGGGTCCCG -> ACGGGTCCCGA
TACGTAGCGCC -> ACGTAGCGCCC
TACGTGAAGTG -> ACGTGAAGTGC
TACGTGAATGG -> ACGTGAATGGC
TACGTTTTAGG -> ACGTTTTAGGA
TACGTTTTGTT -> ACGTTTTGTTG
TACTACATGCC -> ACTACATGCCA
TACTACGGGTC -> ACTACGGGTCC
TACTCACGGCC -> ACTCACGGCCC
TACTCAGGGTA -> ACTCAGGGTAT
TACTCGAAGCG -> ACTCGAAGCGG
TACTCGTGGGT -> ACTCGTGGGTT
TACTGAGTGCC -> ACTGAGTGCCC
TACTTAGAAGA -> ACTTAGAAGAG
TACTTGGGAGC -> ACTTGGGAGCG
TACTTTTGCGT -> ACTTTTGCGTC
TAGAAAGTTAA -> AGAAAGTTAAT
TAGAACACTGG -> AGAACACTGGA
TAGAAGAGCAC -> AGAAGAGCACT
TAGACATATGT -> AGACATATGTT
TAGACTGTCCC -> AGACTGTCCCC
TAGATTATCCC -> AGATTATCCCT
TAGCAATCCTA -> AGCAATCCTAC
TAGCATAATAA -> AGCATAATAAA
TAGCATCTCGC -> AGCATCTCGCT
TAGCCCATCCG -> AGCCCATCCGA
TAGCGAAACTG -> AGCGAAACTGC
TAGCGCCCGAG -> AGCGCCCGAGT
TAGCTAAATAT -> AGCTAAATATT
TAGCTCACCAA -> AGCTCACCAAG
TAGCTCAGCAG -> AGCTCAGCAGA
TAGGAATCTGA -> AGGAATCTGAG
TAGGAGAGCAT -> AGGAGAGCATG
TAGGATTACGT -> AGGATTACGTA
TAGGCACTTCC -> AGGCACTTCCC
TAGGCATCGCC -> AGGCATCGCCA
TAGGCGTCATG -> AGGCGTCATGC
TAGGCTGGGTT -> AGGCTGGGTTC
TAGGGTGCCGG -> AGGGTGCCGGT
TAGGTGCTTCC -> AGGTGCTTCCG
TAGTACACCCC -> AGTACACCCCG
TAGTAGGGTGC -> AGTAGGGTGCC
TAGTCAATTCG -> AGTCAATTCGC
TAGTGCCTTGA -> AGTGCCTTGAC
TAGTGGACTAG -> AGTGGACTAGC
TAGTGTAGCAA -> AGTGTAGCAAT
TAGTGTCACTA -> AGTGTCACTAC
TAGTTGAACAG -> AGTTGAACAGC
TAGTTGAGCCT -> AGTTGAGCCTG
TAGTTGCTTAC -> AGTTGCTTACA
TAGTTTTTTGA -> AGTTTTTTGAA
TATAACGCATG -> ATAACGCATGA
TATAATGACAA -> ATAATGACAAG
TATACCGCACT -> ATACCGCACTA
TATACGTTTTA -> ATACGTTTTAG
TATACTACGGG -> ATACTACGGGT
TATAGTTTTTT -> ATAGTTTTTTG
TATCAGCAGGC -> ATCAGCAGGCC
TATCATGGTTT -> ATCATGGTTTA
TATCCATCCAC -> ATCCATCCACT
TATCCCTCTGC -> ATCCCTCTGCT
TATCCGAAGTG -> ATCCGAAGTGC
TATCCGCTGTT -> ATCCGCTGTTC
TATCCGGCCTC -> ATCCGGCCTCA
TATCGGCGTCA -> ATCGGCGTCAA
TATCTCGCCCG -> ATCTCGCCCGC
TATGACATAAT -> ATGACATAATA
TATGCTATACC -> ATGCTATACCG
TATGGAAGCAC -> ATGGAAGCACT
TATGGATCCTA -> ATGGATCCTAT
TATGTGCCATA -> ATGTGCCATAG
TATGTTAGTGT -> ATGTTAGTGTC
TATTAAGTCAC -> ATTAAGTCACA
TATTAGACTGT -> ATTAGACTGTC
TATTATTAGAC -> ATTATTAGACT
TATTCTCTCTC -> ATTCTCTCTCT
TATTGCAACGC -> ATTGCAACGCA
TATTGGCAAAA -> ATTGGCAAAAC
TATTGTGCAGT -> ATTGTGCAGTC
TATTTGTGCCG -> ATTTGTGCCGT
TATTTTTCTTG -> ATTTTTCTTGC
TCAAACTAGTT -> CAAACTAGTTG
TCAACACCGAG -> CAACACCGAGT
TCAACCAGGTA -> CAACCAGGTAT
TCAACGTACCG -> CAACGTACCGG
TCAACTCAACC -> CAACTCAACCA
TCAAGCCCATA -> CAAGCCCATAC
TCAAGGCCGAA -> CAAGGCCGAAT
TCAATTCGCTG -> CAATTCGCTGC
TCACAAAAGTT -> CACAAAAGTTT
TCACAGAAGGG -> CACAGAAGGGA
TCACCAAGTAA -> CACCAAGTAAT
TCACCTCCTCG -> CACCTCCTCGA
TCACGGCCCGG -> CACGGCCCGGT
TCACGGGAGTT -> CACGGGAGTTT
TCACTACTTTT -> CACTACTTTTG
TCAGACGTGAA -> CAGACGTGAAG
TCAGCAGACCT -> CAGCAGACCTG
TCAGCAGGCCA -> CAGCAGGCCAC
TCAGGGTATAG -> CAGGGTATAGT
TCATAACCCGG -> CATAACCCGGG
TCATCACAGAA -> CATCACAGAAG
TCATCGGATAT -> CATCGGATATG
TCATGAGTTTG -> CATGAGTTTGT
TCATGCGGGGC -> CATGCGGGGCC
TCATGGTTTAT -> CATGGTTTATC
TCATTTATCCG -> CATTTATCCGC
TCATTTTGGAA -> CATTTTGGAAA
TCCAAGTAGCC -> CCAAGTAGCCC
TCCACGGGATA -> CCACGGGATAC
TCCACGTGGCG -> CCACGTGGCGA
TCCACTCTGCT -> CCACTCTGCTG
TCCAGAAGTAC -> CCAGAAGTACA
TCCAGGTAATC -> CCAGGTAATCG
TCCAGTTAAGT -> CCAGTTAAGTT
TCCATACTTAG -> CCATACTTAGA
TCCATATGGAT -> CCATATGGATC
TCCATCCACTC -> CCATCCACTCT
TCCCACCTCTC -> CCCACCTCTCC
TCCCATCCCTG -> CCCATCCCTGT
TCCCCAGTCTG -> CCCCAGTCTGC
TCCCCATAGCA -> CCCCATAGCAT
TCCCGATGCCC -> CCCGATGCCCG
TCCCGCCGTTC -> CCCGCCGTTCG
TCCCGGGGAGC -> CCCGGGGAGCC
TCCCTCTGCTG -> CCCTCTGCTGA
TCCCTGTTTTA -> CCCTGTTTTAG
TCCGAACACAT -> CCGAACACATT
TCCGAAGTGCT -> CCGAAGTGCTC
TCCGACACTGT -> CCGACACTGTG
TCCGAGTCTTA -> CCGAGTCTTAC
TCCGCCCACCG -> CCGCCCACCGT
TCCGCTGTTCT -> CCGCTGTTCTC
TCCGGCCTCAA -> CCGGCCTCAAG
TCCGGGAGAGG -> CCGGGAGAGGA
TCCGTCAGACG -> CCGTCAGACGT
TCCGTCCACGT -> CCGTCCACGTG
TCCGTTAGTAC -> CCGTTAGTACA
TCCTAAAGAGG -> CCTAAAGAGGA
TCCTACATATT -> CCTACATATTG
TCCTACTCACG -> CCTACTCACGG
TCCTAGCATAA -> CCTAGCATAAT
TCCTATTGTGC -> CCTATTGTGCA
TCCTCGAAGTT -> CCTCGAAGTTT
TCCTCTTGAGT -> CCTCTTGAGTG
TCCTGAGGTAG -> CCTGAGGTAGG
TCCTGCAGTAT -> CCTGCAGTATG
TCCTGTGTAGC -> CCTGTGTAGCG
TCCTTCCGTCC -> CCTTCCGTCCA
TCGAAGCGGAA -> CGAAGCGGAAT
TCGAAGTTTAG -> CGAAGTTTAGT
TCGACGAAACT -> CGACGAAACTA
TCGAGCCTGCC -> CGAGCCTGCCC
TCGATACGTTT -> CGATACGTTTT
TCGCATTTACT -> CGCATTTACTC
TCGCCAATTTG -> CGCCAATTTGA
TCGCCCGCAAC -> CGCCCGCAACA
TCGCGTTAGGA -> CGCGTTAGGAG
TCGCTGCTAAA -> CGCTGCTAAAC
TCGCTGGTCCA -> CGCTGGTCCAC
TCGCTTATTTG -> CGCTTATTTGT
TCGGAAAGGTT -> CGGAAAGGTTT
TCGGAGTCCAG -> CGGAGTCCAGG
TCGGATATCCG -> CGGATATCCGG
TCGGATATGTG -> CGGATATGTGC
TCGGCGTCAAC -> CGGCGTCAACA
TCGGGATATTT -> CGGGATATTTT
TCGGTGGATCT -> CGGTGGATCTA
TCGTAGTTGAA -> CGTAGTTGAAC
TCGTATGGAAG -> CGTATGGAAGC
TCGTCGGGATA -> CGTCGGGATAT
TCGTGGGTTCA -> CGTGGGTTCAA
TCGTTAAATTG -> CGTTAAATTGC
TCGTTGGTGGT -> CGTTGGTGGTA
TCTAAAGAGGT -> CTAAAGAGGTA
TCTACGACAGG -> CTACGACAGGG
TCTACTACATG -> CTACTACATGC
TCTATTATTAG -> CTATTATTAGA
TCTCATGAGTT -> CTCATGAGTTT
TCTCCTGTGTA -> CTCCTGTGTAG
TCTCCTTCCGT -> CTCCTTCCGTC
TCTCGCCCGCA -> CTCGCCCGCAA
TCTCGCGTTAG -> CTCGCGTTAGG
TCTCGCTTATT -> CTCGCTTATTT
TCTCGTCGGGA -> CTCGTCGGGAT
TCTCTACTACA -> CTCTACTACAT
TCTCTCTCTTG -> CTCTCTCTTGG
TCTCTCTTGGC -> CTCTCTTGGCA
TCTCTTGGCAA -> CTCTTGGCAAG
TCTGAGGAATC -> CTGAGGAATCC
TCTGCCTGGAG -> CTGCCTGGAGG
TCTGCTGATCC -> CTGCTGATCCC
TCTGCTGGTTA -> CTGCTGGTTAT
TCTGGGCCGAA -> CTGGGCCGAAG
TCTGGTCATCA -> CTGGTCATCAC
TCTTACCTGTA -> CTTACCTGTAG
TCTTGAGTGCA -> CTTGAGTGCAT
TCTTGCCATAG -> CTTGCCATAGC
TCTTGGCAAGA -> CTTGGCAAGAG
TCTTGTGATAG -> CTTGTGATAGG
TCTTTCGGTGG -> CTTTCGGTGGA
TGAACAGCTCC -> GAACAGCTCCT
TGAAGAAGTTA -> GAAGAAGTTAG
TGAAGAATCGA -> GAAGAATCGAT
TGAAGACACAC -> GAAGACACACA
TGAAGTGCCTG -> GAAGTGCCTGC
TGAATGGCCCA -> GAATGGCCCAG
TGAATTTAACG -> GAATTTAACGC
TGACAAGACTC -> GACAAGACTCA
TGACACTTTAC -> GACACTTTACC
TGACAGGTAAC -> GACAGGTAACT
TGACATAATAG -> GACATAATAGT
TGACGACCTTA -> GACGACCTTAC
TGACGCGTCCC -> GACGCGTCCCC
TGACGCTCCAG -> GACGCTCCAGA
TGACGTAAGAA -> GACGTAAGAAA
TGACTAGGCGT -> GACTAGGCGTC
TGAGAGAGACT -> GAGAGAGACTG
TGAGCCTGGAG -> GAGCCTGGAGA
TGAGGAATCCA -> GAGGAATCCAT
TGAGGATACGC -> GAGGATACGCC
TGAGGTAGGTG -> GAGGTAGGTGC
TGAGTGAAGAA -> GAGTGAAGAAT
TGAGTGAAGAC -> GAGTGAAGACA
TGAGTGCATTT -> GAGTGCATTTT
TGAGTGCCCCA -> GAGTGCCCCAT
TGAGTTTGTGG -> GAGTTTGTGGT
TGATAGGCATC -> GATAGGCATCG
TGATATAACGC -> GATATAACGCA
TGATCCCATCC -> GATCCCATCCC
TGATCTGGGCC -> GATCTGGGCCG
TGATGCGTAAT -> GATGCGTAATG
TGATGGATTTA -> GATGGATTTAC
TGCAAATCCGT -> GCAAATCCGTC
TGCAACGCAGT -> GCAACGCAGTA
TGCAAGCCTCC -> GCAAGCCTCCT
TGCAATTAATG -> GCAATTAATGG
TGCACTTATCA -> GCACTTATCAT
TGCAGAGCAGG -> GCAGAGCAGGC
TGCAGTATGCT -> GCAGTATGCTA
TGCAGTCTGGT -> GCAGTCTGGTC
TGCATTTTACA -> GCATTTTACAG
TGCCAAGTTGT -> GCCAAGTTGTC
TGCCAATTTAG -> GCCAATTTAGA
TGCCACTTCAT -> GCCACTTCATA
TGCCATAGCTC -> GCCATAGCTCA
TGCCATAGTGT -> GCCATAGTGTA
TGCCCCATGAC -> GCCCCATGACG
TGCCCCTACGG -> GCCCCTACGGA
TGCCCGTCCGG -> GCCCGTCCGGG
TGCCGCACTCC -> GCCGCACTCCA
TGCCGGTGTTA -> GCCGGTGTTAC
TGCCGTAAAGT -> GCCGTAAAGTT
TGCCTAATGAT -> GCCTAATGATC
TGCCTAGGAAT -> GCCTAGGAATC
TGCCTCAACGT -> GCCTCAACGTA
TGCCTGCAAGC -> GCCTGCAAGCC
TGCCTGGAGGG -> GCCTGGAGGGC
TGCCTTGACGC -> GCCTTGACGCG
TGCCTTTCCAA -> GCCTTTCCAAG
TGCGCCGTCCC -> GCGCCGTCCCG
TGCGCGCTAGG -> GCGCGCTAGGC
TGCGGGGCCGC -> GCGGGGCCGCT
TGCGGGTCGTT -> GCGGGTCGTTA
TGCGTAATGGG -> GCGTAATGGGT
TGCGTATAATG -> GCGTATAATGA
TGCGTCCTAAA -> GCGTCCTAAAG
TGCTAAACGGT -> GCTAAACGGTT
TGCTATACCGC -> GCTATACCGCA
TGCTCCTCTTG -> GCTCCTCTTGA
TGCTCTCCTGT -> GCTCTCCTGTG
TGCTGATCCCA -> GCTGATCCCAT
TGCTGGTTATT -> GCTGGTTATTG
TGCTTACAACC -> GCTTACAACCT
TGCTTCCGCCC -> GCTTCCGCCCA
TGGAAAGCACC -> GGAAAGCACCC
TGGAAGAGAGT -> GGAAGAGAGTA
TGGAAGCACTT -> GGAAGCACTTT
TGGACTAGCTC -> GGACTAGCTCA
TGGAGAATATA -> GGAGAATATAC
TGGAGGGCCTC -> GGAGGGCCTCT
TGGATCCTATT -> GGATCCTATTG
TGGATCTACGA -> GGATCTACGAC
TGGATGATGCG -> GGATGATGCGT
TGGATTTACTC -> GGATTTACTCA
TGGCAAAACTC -> GGCAAAACTCA
TGGCAAGAGGT -> GGCAAGAGGTC
TGGCACTGTCG -> GGCACTGTCGG
TGGCCCAGCTG -> GGCCCAGCTGG
TGGCGAAAGTC -> GGCGAAAGTCA
TGGCTGATATA -> GGCTGATATAA
TGGGAACGGTA -> GGGAACGGTAC
TGGGAGCGAGG -> GGGAGCGAGGT
TGGGCCGAAGG -> GGGCCGAAGGA
TGGGGGTCCGA -> GGGGGTCCGAG
TGGGTCAAACT -> GGGTCAAACTA
TGGGTTCAATG -> GGGTTCAATGT
TGGGTTCTATT -> GGGTTCTATTA
TGGTAATAATG -> GGTAATAATGC
TGGTCATCACA -> GGTCATCACAG
TGGTCCACGGG -> GGTCCACGGGA
TGGTCGGATAT -> GGTCGGATATC
TGGTGGTAATA -> GGTGGTAATAA
TGGTGTTTAAG -> GGTGTTTAAGT
TGGTTATTGGC -> GGTTATTGGCA
TGGTTTACATT -> GGTTTACATTG
TGGTTTATCTC -> GGTTTATCTCG
TGTAACTAACA -> GTAACTAACAG
TGTAGCAATCC -> GTAGCAATCCT
TGTAGCGAAAC -> GTAGCGAAACT
TGTAGGCTGGG -> GTAGGCTGGGT
TGTATCAGCAG -> GTATCAGCAGG
TGTCACGGGAG -> GTCACGGGAGT
TGTCACTACTT -> GTCACTACTTT
TGTCCCCAGTC -> GTCCCCAGTCT
TGTCGCTGGTC -> GTCGCTGGTCC
TGTCGGAAAGG -> GTCGGAAAGGT
TGTCGGAGTCC -> GTCGGAGTCCA
TGTCTAAAGAG -> GTCTAAAGAGG
TGTGACACTTT -> GTGACACTTTA
TGTGAGTGAAG -> GTGAGTGAAGA,GTGAGTGAAGA
TGTGATAGGCA -> GTGATAGGCAT
TGTGCAGTCTG -> GTGCAGTCTGG
TGTGCCACTTC -> GTGCCACTTCA
TGTGCCATAGT -> GTGCCATAGTG
TGTGCCGTAAA -> GTGCCGTAAAG
TGTGGTGTTTA -> GTGGTGTTTAA
TGTGTAGCGAA -> GTGTAGCGAAA
TGTTACATGGA -> GTTACATGGAT
TGTTAGTGTCA -> GTTAGTGTCAC
TGTTCTCGCGT -> GTTCTCGCGTT
TGTTGCGCGCT -> GTTGCGCGCTA
TGTTTAAGTAA -> GTTTAAGTAAG
TGTTTTAGTGC -> GTTTTAGTGCC
TTAAACTTATC -> TAAACTTATCC
TTAAATTGCAG -> TAAATTGCAGA
TTAACGCTTCC -> TAACGCTTCCG
TTAAGTAAGCT -> TAAGTAAGCTA
TTAAGTCACAA -> TAAGTCACAAA
TTAAGTTAGTG -> TAAGTTAGTGG
TTAATCCGTTA -> TAATCCGTTAG
TTAATGGTTTA -> TAATGGTTTAC
TTACAACCTAA -> TACAACCTAAG
TTACAGTTGTG -> TACAGTTGTGA
TTACATGGATG -> TACATGGATGA
TTACATTGGCT -> TACATTGGCTG
TTACCAGGCAC -> TACCAGGCACT
TTACCTGTAGG -> TACCTGTAGGC
TTACGTAGCGC -> TACGTAGCGCC
TTACGTGAAGT -> TACGTGAAGTG
TTACTCAGGGT -> TACTCAGGGTA
TTACTCGAAGC -> TACTCGAAGCG
TTACTTGGGAG -> TACTTGGGAGC
TTAGAAGAGCA -> TAGAAGAGCAC
TTAGACATATG -> TAGACATATGT
TTAGACTGTCC -> TAGACTGTCCC
TTAGATTATCC -> TAGATTATCCC
TTAGCTAAATA -> TAGCTAAATAT
TTAGGAGAGCA -> TAGGAGAGCAT
TTAGGATTACG -> TAGGATTACGT
TTAGTACACCC -> TAGTACACCCC
TTAGTGCCTTG -> TAGTGCCTTGA
TTAGTGGACTA -> TAGTGGACTAG
TTAGTGTCACT -> TAGTGTCACTA
TTAGTTGCTTA -> TAGTTGCTTAC
TTATCATGGTT -> TATCATGGTTT
TTATCCATCCA -> TATCCATCCAC
TTATCCCTCTG -> TATCCCTCTGC
TTATCCGCTGT -> TATCCGCTGTT
TTATCTCGCCC -> TATCTCGCCCG
TTATGACATAA -> TATGACATAAT
TTATTAAGTCA -> TATTAAGTCAC
TTATTAGACTG -> TATTAGACTGT
TTATTGGCAAA -> TATTGGCAAAA
TTATTTGTGCC -> TATTTGTGCCG
TTCATAACCCG -> TCATAACCCGG
TTCATTTATCC -> TCATTTATCCG
TTCCAAGTAGC -> TCCAAGTAGCC
TTCCCGCCGTT -> TCCCGCCGTTC
TTCCGACACTG -> TCCGACACTGT
TTCCGCCCACC -> TCCGCCCACCG
TTCCGTCCACG -> TCCGTCCACGT
TTCGACGAAAC -> TCGACGAAACT
TTCGAGCCTGC -> TCGAGCCTGCC
TTCGCTGCTAA -> TCGCTGCTAAA
TTCGGTGGATC -> TCGGTGGATCT
TTCGTATGGAA -> TCGTATGGAAG
TTCGTTGGTGG -> TCGTTGGTGGT
TTCTATTATTA -> TCTATTATTAG
TTCTCGCGTTA -> TCTCGCGTTAG
TTCTCTCTCTT -> TCTCTCTCTTG
TTCTTGCCATA -> TCTTGCCATAG
TTGAACAGCTC -> TGAACAGCTCC
TTGAATTTAAC -> TGAATTTAACG
TTGACGCGTCC -> TGACGCGTCCC
TTGACTAGGCG -> TGACTAGGCGT
TTGAGAGAGAC -> TGAGAGAGACT
TTGAGCCTGGA -> TGAGCCTGGAG
TTGAGTGCATT -> TGAGTGCATTT
TTGCAACGCAG -> TGCAACGCAGT
TTGCAGAGCAG -> TGCAGAGCAGG
TTGCCATAGCT -> TGCCATAGCTC
TTGCCTAATGA -> TGCCTAATGAT
TTGCGCGCTAG -> TGCGCGCTAGG
TTGCGTATAAT -> TGCGTATAATG
TTGCGTCCTAA -> TGCGTCCTAAA
TTGCTTACAAC -> TGCTTACAACC
TTGGAAAGCAC -> TGGAAAGCACC
TTGGCAAAACT -> TGGCAAAACTC
TTGGCAAGAGG -> TGGCAAGAGGT
TTGGCTGATAT -> TGGCTGATATA
TTGGGAGCGAG -> TGGGAGCGAGG
TTGGTGGTAAT -> TGGTGGTAATA
TTGTATCAGCA -> TGTATCAGCAG
TTGTCGCTGGT -> TGTCGCTGGTC
TTGTGACACTT -> TGTGACACTTT
TTGTGATAGGC -> TGTGATAGGCA
TTGTGCAGTCT -> TGTGCAGTCTG
TTGTGCCGTAA -> TGTGCCGTAAA
TTGTGGTGTTT -> TGTGGTGTTTA
TTGTTGCGCGC -> TGTTGCGCGCT
TTTAACGCTTC -> TTAACGCTTCC
TTTAAGTAAGC -> TTAAGTAAGCT
TTTACAGTTGT -> TTACAGTTGTG
TTTACATTGGC -> TTACATTGGCT
TTTACCAGGCA -> TTACCAGGCAC
TTTACTCAGGG -> TTACTCAGGGT
TTTACTCGAAG -> TTACTCGAAGC
TTTAGACATAT -> TTAGACATATG
TTTAGGATTAC -> TTAGGATTACG
TTTAGTGCCTT -> TTAGTGCCTTG
TTTAGTTGCTT -> TTAGTTGCTTA
TTTATCCGCTG -> TTATCCGCTGT
TTTATCTCGCC -> TTATCTCGCCC
TTTCCAAGTAG -> TTCCAAGTAGC
TTTCGACGAAA -> TTCGACGAAAC
TTTCGGTGGAT -> TTCGGTGGATC
TTTCGTTGGTG -> TTCGTTGGTGG
TTTCTTGCCAT -> TTCTTGCCATA
TTTGAATTTAA -> TTGAATTTAAC
TTTGACTAGGC -> TTGACTAGGCG
TTTGAGAGAGA -> TTGAGAGAGAC
TTTGCCTAATG -> TTGCCTAATGA
TTTGCGTATAA -> TTGCGTATAAT
TTTGCGTCCTA -> TTGCGTCCTAA
TTTGGAAAGCA -> TTGGAAAGCAC
TTTGTGCCGTA -> TTGTGCCGTAA
TTTGTGGTGTT -> TTGTGGTGTTT
TTTGTTGCGCG -> TTGTTGCGCGC
TTTTACAGTTG -> TTTACAGTTGT
TTTTAGGATTA -> TTTAGGATTAC
TTTTAGTGCCT -> TTTAGTGCCTT
TTTTCTTGCCA -> TTTCTTGCCAT
TTTTGAATTTA -> TTTGAATTTAA
TTTTGAGAGAG -> TTTGAGAGAGA
TTTTGCCTAAT -> TTTGCCTAATG
TTTTGCGTCCT -> TTTGCGTCCTA
TTTTGGAAAGC -> TTTGGAAAGCA
TTTTGTTGCGC -> TTTGTTGCGCG
TTTTTCTTGCC -> TTTTCTTGCCA
TTTTTGAATTT -> TTTTGAATTTA
TTTTTTGAATT -> TTTTTGAATTT
