GTGTTGGTATTGACCTGAT -> TGTTGGTATTGACCTGATG
ACGGACTTTGGTTCGGTGA -> CGGACTTTGGTTCGGTGAC
ATATGGCGGTCCAGTGCCG -> TATGGCGGTCCAGTGCCGC
TTGGTACACATAATGTGCG -> TGGTACACATAATGTGCGA
CGCCGAGATAGATTAACCC -> GCCGAGATAGATTAACCCG
GTCCAGTGCCGCAGACTAC -> TCCAGTGCCGCAGACTACA
AGCTAGTAGAAGGGGGTGA -> GCTAGTAGAAGGGGGTGAC
GTAAAATACGATACTGACC -> TAAAATACGATACTGACCC
ACAGGAAGTTCTAGGGTCA -> CAGGAAGTTCTAGGGTCAT
GTCTCGGCTTACGATGATA -> TCTCGGCTTACGATGATAC
CAAGATGGATTCGCCCGCA -> AAGATGGATTCGCCCGCAC
GACGGGCCAAGGCTATATT -> ACGGGCCAAGGCTATATTG
AGCAATCCTCGTAGCCGAA -> GCAATCCTCGTAGCCGAAG
ACGCGGAGCCCTGCGGTTG -> CGCGGAGCCCTGCGGTTGA
AGGTAAGTGACATAGACGC -> GGTAAGTGACATAGACGCC
GCTATGGCCACGGAGTCCT -> CTATGGCCACGGAGTCCTA
TCACGCGGAGCCCTGCGGT -> CACGCGGAGCCCTGCGGTT
GACATAGACGCCGAGATAG -> ACATAGACGCCGAGATAGA
ATTGTGGTCAGCTAGCCGG -> TTGTGGTCAGCTAGCCGGT
CTAAATTACCCGAGAGTTA -> TAAATTACCCGAGAGTTAG
CGCCCTTGAGTATTTTTCG -> GCCCTTGAGTATTTTTCGA
TACAGCACGCCGCCACGAC -> ACAGCACGCCGCCACGACA
ACGCCGAGATAGATTAACC -> CGCCGAGATAGATTAACCC
CTAGTGGCGCCGTTCTTTA -> TAGTGGCGCCGTTCTTTAT
TCCAGATGCCTACCGAAGG -> CCAGATGCCTACCGAAGGT
ATTGGTACACATAATGTGC -> TTGGTACACATAATGTGCG
GTGACAAGTATAACGGAAA -> TGACAAGTATAACGGAAAT
ATGGTAACTGATTATTACT -> TGGTAACTGATTATTACTA
GCAGCTCTAGCCATCTCAG -> CAGCTCTAGCCATCTCAGG
AGTTTTATAAGTGTTGGTA -> GTTTTATAAGTGTTGGTAT
AGCTCTAGCCATCTCAGGC -> GCTCTAGCCATCTCAGGCT
CCGTCTCTTGATGGAGGGA -> CGTCTCTTGATGGAGGGAG
GCACCTTATAGCAAATTCA -> CACCTTATAGCAAATTCAA
TACGATGATACTGGACCAA -> ACGATGATACTGGACCAAC
AGTGCTTACGATGATACTG -> GTGCTTACGATGATACTGG
CGACTTGGCGTGTAAGTCC -> GACTTGGCGTGTAAGTCCA
TGCCCGGCTACAGCACGCC -> GCCCGGCTACAGCACGCCG
CTTGATGGAGGGAGTAGAC -> TTGATGGAGGGAGTAGACC
CATCAAACGCTATGGCCAC -> ATCAAACGCTATGGCCACG
TTTATTCTTGGAGGGAGAT -> TTATTCTTGGAGGGAGATC
GCCGGTGGCGTCACCACAA -> CCGGTGGCGTCACCACAAA
AGACATGGGGTCACCTCCT -> GACATGGGGTCACCTCCTT
ATTCGCCCGCACGGTCCAG -> TTCGCCCGCACGGTCCAGA
TCCAAAGCTGATATGGCGG -> CCAAAGCTGATATGGCGGT
TCGGCTTACGATGATACTG -> CGGCTTACGATGATACTGG
TAGAAGGGGGTGACGGGCC -> AGAAGGGGGTGACGGGCCA
TATTCAGAATAAGCGGCAA -> ATTCAGAATAAGCGGCAAC
CGGTTCTCGATCCTAACCA -> GGTTCTCGATCCTAACCAT
ACCCGCCGAAGTACAGTTA -> CCCGCCGAAGTACAGTTAT
TTGGTCTAGTGGCGCCGTT -> TGGTCTAGTGGCGCCGTTC
GCAAGTAATTTCACTTAGC -> CAAGTAATTTCACTTAGCA
CTCTTTCCGGGAAATAAAA -> TCTTTCCGGGAAATAAAAA
AGATAATTGACCTGAAGCA -> GATAATTGACCTGAAGCAG
TGATAGACGTGCCCGGCTA -> GATAGACGTGCCCGGCTAC
CTAGTTCTAAATTACCCGA -> TAGTTCTAAATTACCCGAG
ATGGCTTCCTGACTATGTT -> TGGCTTCCTGACTATGTTA
ACGGTCCAGAACGTTACGG -> CGGTCCAGAACGTTACGGT
AAGTGGTTCGGTGACCCCG -> AGTGGTTCGGTGACCCCGA
TTGGTCTCTTTCCGGGAAA -> TGGTCTCTTTCCGGGAAAT
AGTGTATCGGTTCGTCGAT -> GTGTATCGGTTCGTCGATT
GTGACCCCGACTCTCAGAC -> TGACCCCGACTCTCAGACT
CCTTGCAAGTAGAGGTAAG -> CTTGCAAGTAGAGGTAAGT
GTTATGTCGGTAGACTAAG -> TTATGTCGGTAGACTAAGG
TTTAGCTAGTTCTAAATTA -> TTAGCTAGTTCTAAATTAC
GCTGCCGTATTAGCTGCCC -> CTGCCGTATTAGCTGCCCC
CTGCCACTCTTTAAGCAAA -> TGCCACTCTTTAAGCAAAT
ACAAAGAACAGAAGAGATA -> CAAAGAACAGAAGAGATAT
TGCAAGTAGAGGTAAGTGA -> GCAAGTAGAGGTAAGTGAC
ATGCACGGACTTTGGTTCG -> TGCACGGACTTTGGTTCGG
AGTCGCATTATTAACAAGT -> GTCGCATTATTAACAAGTA
GCGTCACCACAAAGATCGC -> CGTCACCACAAAGATCGCT
GTGCCGCAGACTACATCGA -> TGCCGCAGACTACATCGAG
GTGTCTGTAAATATCGGCT -> TGTCTGTAAATATCGGCTC
CAGAATAAGCGGCAACGAG -> AGAATAAGCGGCAACGAGC
CACGTGGTCGTCCCGCGTC -> ACGTGGTCGTCCCGCGTCA
CCCGAGAGTTAGATCATAG -> CCGAGAGTTAGATCATAGA
CATTTGGTCTCTTTCCGGG -> ATTTGGTCTCTTTCCGGGA
TTTCCTTGAATGTGCTGGA -> TTCCTTGAATGTGCTGGAT
AGAGGTAAGTGACATAGAC -> GAGGTAAGTGACATAGACG
CTCACGATGCACCCCACAG -> TCACGATGCACCCCACAGA
TCTTTCCGGGAAATAAAAA -> CTTTCCGGGAAATAAAAAA
ATGGCCACGGAGTCCTATT -> TGGCCACGGAGTCCTATTC
TCACGATGCACCCCACAGA -> CACGATGCACCCCACAGAA
CCTGCGACATACGGGTCTC -> CTGCGACATACGGGTCTCG
TATTAACAAGTAGCTTGTG -> ATTAACAAGTAGCTTGTGC
GGTGGCCGTTACACCCCGC -> GTGGCCGTTACACCCCGCC
CCGCTGGTGAACAATAGCC -> CGCTGGTGAACAATAGCCT
AATACAATACTAGTTAAGC -> ATACAATACTAGTTAAGCT
GGCTACAGCACGCCGCCAC -> GCTACAGCACGCCGCCACG
ATACCAATATTTCATCAGT -> TACCAATATTTCATCAGTG
CAAGATAATTGACCTGAAG -> AAGATAATTGACCTGAAGC
TTATAGCAAATTCAAGGTG -> TATAGCAAATTCAAGGTGA
GATGCACGGACTTTGGTTC -> ATGCACGGACTTTGGTTCG
GACCCCCCAGTTTTTCCAG -> ACCCCCCAGTTTTTCCAGA
TTATTGTACTAAACAACGA -> TATTGTACTAAACAACGAA
TCCGGGATTAGAAGCAGCG -> CCGGGATTAGAAGCAGCGA
TAGCACCTTGTAAGTTTAG -> AGCACCTTGTAAGTTTAGC
TCGTCTATGTTTATTAGTA -> CGTCTATGTTTATTAGTAT
AGCGACCCCCCACCCGCCG -> GCGACCCCCCACCCGCCGA
TTCTAACGAATACAATACT -> TCTAACGAATACAATACTA
GAAGTTCTAGGGTCATGTT -> AAGTTCTAGGGTCATGTTG
TAACTACGATGCGGGATTG -> AACTACGATGCGGGATTGC
CAAGTGATATACCAATATT -> AAGTGATATACCAATATTT
GTAGAGGTAAGTGACATAG -> TAGAGGTAAGTGACATAGA
GTTAGATCATAGACTATAC -> TTAGATCATAGACTATACT
AACACACTGGGTATAGTAA -> ACACACTGGGTATAGTAAA
AGCCCTAGTGTCTGTAAAT -> GCCCTAGTGTCTGTAAATA
TCTTGATGGAGGGAGTAGA -> CTTGATGGAGGGAGTAGAC
AATACTAGTTAAGCTCGGC -> ATACTAGTTAAGCTCGGCG
ACTGGAGATGTGACAAGTG -> CTGGAGATGTGACAAGTGG
GCCGTCTAGGCATAGCGAC -> CCGTCTAGGCATAGCGACC
TGTTTATTAGTATCTCTAG -> GTTTATTAGTATCTCTAGT
TTCGGTGACCCCGACTGCA -> TCGGTGACCCCGACTGCAA
GTGGCGCCGTTCTTTATTG -> TGGCGCCGTTCTTTATTGT
GAAGCAATGGCTAGTAACA -> AAGCAATGGCTAGTAACAT
GAAGTACGGTTCTCGATCC -> AAGTACGGTTCTCGATCCT
ATGATACTGGACCAACCCT -> TGATACTGGACCAACCCTG
ATACGATTAATGAGCCTGC -> TACGATTAATGAGCCTGCG
TGGCTTCCTGACTATGTTA -> GGCTTCCTGACTATGTTAA
CCGAAGCAGCTCTAGCCAT -> CGAAGCAGCTCTAGCCATC
CTTGTAAGTTTAGCTTACG -> TTGTAAGTTTAGCTTACGA
ACATGGGGTCACCTCCTTT -> CATGGGGTCACCTCCTTTT
AAGCAGCTCTAGCCATCTC -> AGCAGCTCTAGCCATCTCA
TGTAAGTTTAGCTTACGAT -> GTAAGTTTAGCTTACGATG
GGTCACCTCCTTTTTAAGC -> GTCACCTCCTTTTTAAGCA
CCCGCACGGTCCAGAACGT -> CCGCACGGTCCAGAACGTT
TAAGCGGCAACGAGCACTC -> AAGCGGCAACGAGCACTCG
CCGACGATCGCTGCCGTAT -> CGACGATCGCTGCCGTATT
TAGATCATAGACTATACTG -> AGATCATAGACTATACTGC
GGGCCAAGGCTATATTGCC -> GGCCAAGGCTATATTGCCG
GGGACTCTATGGTTCGGTG -> GGACTCTATGGTTCGGTGA
TGCTGGATCACGTGGTCGT -> GCTGGATCACGTGGTCGTC
CGAAGCAGCTCTAGCCATC -> GAAGCAGCTCTAGCCATCT
GATGGATTCGCCCGCACGG -> ATGGATTCGCCCGCACGGT
ATCGAGTAAGTGGTCACCT -> TCGAGTAAGTGGTCACCTG
ACCACCTCAACAACAAGAT -> CCACCTCAACAACAAGATG
AGTATCTCTAGTCGCATTA -> GTATCTCTAGTCGCATTAT
CATGCACCTTATAGCAAAT -> ATGCACCTTATAGCAAATT
ATTTAGCTAGTTCTAAATT -> TTTAGCTAGTTCTAAATTA
CTGACTATGTTAACTACGA -> TGACTATGTTAACTACGAT
TAGGCATAGCGACCCCCCA -> AGGCATAGCGACCCCCCAC
GGAAATTCAATGTAATCAG -> GAAATTCAATGTAATCAGC
TAAAGATATTTTTAGTTTT -> AAAGATATTTTTAGTTTTA
ACTGCTGCCACTCTTTAAG -> CTGCTGCCACTCTTTAAGC
ATAGACATGGGGTCACCTC -> TAGACATGGGGTCACCTCC
TTTTTAAACTCCAAGTGAT -> TTTTAAACTCCAAGTGATA
TACCCGAGAGTTAGATCAT -> ACCCGAGAGTTAGATCATA
CCGACTCAGAGGTGGATCC -> CGACTCAGAGGTGGATCCA
CTCAAGCCGCCCTTGAGTA -> TCAAGCCGCCCTTGAGTAT
GGTATAGTAAAACCGTGCA -> GTATAGTAAAACCGTGCAT
GTAAGTGACATAGACGCCG -> TAAGTGACATAGACGCCGA
GCATGTAAGCCATTTAGCT -> CATGTAAGCCATTTAGCTA
TGCATATTCAGAATAAGCG -> GCATATTCAGAATAAGCGG
TAACCATAAGTCGTCACGC -> AACCATAAGTCGTCACGCG
GTAAAACCGTGCATATTCA -> TAAAACCGTGCATATTCAG
CCTGTATCTGCCTCGCCCG -> CTGTATCTGCCTCGCCCGT
ACAATACTAGTTAAGCTCG -> CAATACTAGTTAAGCTCGG
TTTCTAACGAATACAATAC -> TTCTAACGAATACAATACT
TCAGAATAAGCGGCAACGA -> CAGAATAAGCGGCAACGAG
ACAAGTAGCTTGTGCACAA -> CAAGTAGCTTGTGCACAAA
TTGACCTGAAGCAGACTTC -> TGACCTGAAGCAGACTTCG
GACCTGAAGCAGACTTCGG -> ACCTGAAGCAGACTTCGGC
TATAGCAAATTCAAGGTGA -> ATAGCAAATTCAAGGTGAC
CTCGCCCGTTCCCTTTCCT -> TCGCCCGTTCCCTTTCCTT
GATTCGCCCGCACGGTCCA -> ATTCGCCCGCACGGTCCAG
TCGCATGTAAGCCATTTAG -> CGCATGTAAGCCATTTAGC
CCTGTATGGTTCGGTGACC -> CTGTATGGTTCGGTGACCC
ACAACGAGTAGCGTCGCAT -> CAACGAGTAGCGTCGCATG
ACATCGAGACAAGCTAGTA -> CATCGAGACAAGCTAGTAG
GAAGGGGGTGACGGGCCAA -> AAGGGGGTGACGGGCCAAG
GGCGAAGCCGGTGGCGTCA -> GCGAAGCCGGTGGCGTCAC
TAGCTTACGATGATACTGG -> AGCTTACGATGATACTGGA
ACAAGTGGTTCGGTGACCC -> CAAGTGGTTCGGTGACCCC
GCAGACTTCGGCCGTCTAG -> CAGACTTCGGCCGTCTAGG
AGAACAGAAGAGATATATA -> GAACAGAAGAGATATATAG
CAGAAGAGATATATAGGCA -> AGAAGAGATATATAGGCAC
CCGACTTGGCGTGTAAGTC -> CGACTTGGCGTGTAAGTCC
CAAAGCTGATATGGCGGTC -> AAAGCTGATATGGCGGTCC
CCGACTGCAATGGTGCGTT -> CGACTGCAATGGTGCGTTC
CCGGCTACAGCACGCCGCC -> CGGCTACAGCACGCCGCCA
CGAATACAATACTAGTTAA -> GAATACAATACTAGTTAAG
CTATTACTCTCAAGCCGCC -> TATTACTCTCAAGCCGCCC
GATGGTAACTGATTATTAC -> ATGGTAACTGATTATTACT
GAAGCAGACTTCGGCCGTC -> AAGCAGACTTCGGCCGTCT
GCTGGTGAACAATAGCCTG -> CTGGTGAACAATAGCCTGC
GACATACGGGTCTCGGCTT -> ACATACGGGTCTCGGCTTA
GATTTATCTAGCGTCAGTG -> ATTTATCTAGCGTCAGTGC
CCAGTAGGGTCGTCAAAAC -> CAGTAGGGTCGTCAAAACT
GGTGGATCCATTGTGAGGC -> GTGGATCCATTGTGAGGCG
ACTCAAAGCCGCAGATGGT -> CTCAAAGCCGCAGATGGTA
ACCCGCTCGGAGCGATCAT -> CCCGCTCGGAGCGATCATA
AGTAGCGTCGCATGTAAGC -> GTAGCGTCGCATGTAAGCC
GTAGCGTCGCATGTAAGCC -> TAGCGTCGCATGTAAGCCA
TCGCAACAGGAAGTTCTAG -> CGCAACAGGAAGTTCTAGG
ATCTCTAGTCGCATTATTA -> TCTCTAGTCGCATTATTAA
ATTTATTCTTGGAGGGAGA -> TTTATTCTTGGAGGGAGAT
AACGAGTAGCGTCGCATGT -> ACGAGTAGCGTCGCATGTA
TCGTCACGCGGAGCCCTGC -> CGTCACGCGGAGCCCTGCG
TTGGTTCGGTGACCCCGAC -> TGGTTCGGTGACCCCGACT
CTAGGGTCATGTTGGAGAC -> TAGGGTCATGTTGGAGACT
GCACGCGCGCTCTCTAATA -> CACGCGCGCTCTCTAATAG
TCTCCTGAGCCGGGTCTGG -> CTCCTGAGCCGGGTCTGGG
AGACCGGGTTTGGGCAAGT -> GACCGGGTTTGGGCAAGTA
TTCGATCACATCAAACGCT -> TCGATCACATCAAACGCTA
GTAACTGATTATTACTATT -> TAACTGATTATTACTATTA
GTGGTTCGGTGACCCCGAC -> TGGTTCGGTGACCCCGACT
ATTTCGCGTCGCTGCACGA -> TTTCGCGTCGCTGCACGAG
GATTAGAAGCAGCGATTGT -> ATTAGAAGCAGCGATTGTA
ACTCGTCTATGTTTATTAG -> CTCGTCTATGTTTATTAGT
TAATTTCACTTAGCACCTT -> AATTTCACTTAGCACCTTG
ACTGTGTTCGATCACATCA -> CTGTGTTCGATCACATCAA
ATCCGACATCGAGTAAGTG -> TCCGACATCGAGTAAGTGG
TTTATAAGTGTTGGTATTG -> TTATAAGTGTTGGTATTGA
TGTGACAAGTGGTTCGGTG -> GTGACAAGTGGTTCGGTGA
TTGTGAGGCGAAGCCGGTG -> TGTGAGGCGAAGCCGGTGG
CACATATTTATTCTTGGAG -> ACATATTTATTCTTGGAGG
GGTAAGTGACATAGACGCC -> GTAAGTGACATAGACGCCG
TAGCTAGTTCTAAATTACC -> AGCTAGTTCTAAATTACCC
CTCTCCTGAGCCGGGTCTG -> TCTCCTGAGCCGGGTCTGG
CCTACCGAAGGTTTAGAGA -> CTACCGAAGGTTTAGAGAT
TGGCGGTCCAGTGCCGCAG -> GGCGGTCCAGTGCCGCAGA
GCCTGCGACATACGGGTCT -> CCTGCGACATACGGGTCTC
GCGTTCCGATTGTGGTCAG -> CGTTCCGATTGTGGTCAGC
TGACCTGAAGCAGACTTCG -> GACCTGAAGCAGACTTCGG
TAGTAAAACCGTGCATATT -> AGTAAAACCGTGCATATTC
ATTCTATTGGTACACATAA -> TTCTATTGGTACACATAAT
AGCATACGATTAATGAGCC -> GCATACGATTAATGAGCCT
ACGAGTAAAATACGATACT -> CGAGTAAAATACGATACTG
GACTATGTTAACTACGATG -> ACTATGTTAACTACGATGC
TTCTAAATTACCCGAGAGT -> TCTAAATTACCCGAGAGTT
GAAGAGATATATAGGCACG -> AAGAGATATATAGGCACGC
TACATCGAGACAAGCTAGT -> ACATCGAGACAAGCTAGTA
ACTAAACAACGAAATCACC -> CTAAACAACGAAATCACCC
ATCGGTTCGTCGATTTTCG -> TCGGTTCGTCGATTTTCGA
TCAAGCCGCCCTTGAGTAT -> CAAGCCGCCCTTGAGTATT
TTCTCGATCCTAACCATAA -> TCTCGATCCTAACCATAAG
AAGCCGGTGGCGTCACCAC -> AGCCGGTGGCGTCACCACA
TACTGCTGCCACTCTTTAA -> ACTGCTGCCACTCTTTAAG
TTCTTTATTGTACTAAACA -> TCTTTATTGTACTAAACAA
CGAGTAGCGTCGCATGTAA -> GAGTAGCGTCGCATGTAAG
CATTATTAACAAGTAGCTT -> ATTATTAACAAGTAGCTTG
TAGACATGGGGTCACCTCC -> AGACATGGGGTCACCTCCT
CGTCTATGTTTATTAGTAT -> GTCTATGTTTATTAGTATC
TCTAGGCATAGCGACCCCC -> CTAGGCATAGCGACCCCCC
ACCGTGCATATTCAGAATA -> CCGTGCATATTCAGAATAA
CGATTGTACAACGAGTAGC -> GATTGTACAACGAGTAGCG
CAACGAGTAGCGTCGCATG -> AACGAGTAGCGTCGCATGT
AACGCTATGGCCACGGAGT -> ACGCTATGGCCACGGAGTC
AACATTTGGTCTCTTTCCG -> ACATTTGGTCTCTTTCCGG
TAGTATCTCTAGTCGCATT -> AGTATCTCTAGTCGCATTA
GAGAGTTAGATCATAGACT -> AGAGTTAGATCATAGACTA
CGAGTCGCCCAGGCCACGC -> GAGTCGCCCAGGCCACGCT
AAGTCGTCACGCGGAGCCC -> AGTCGTCACGCGGAGCCCT
GGCCACGGAGTCCTATTCT -> GCCACGGAGTCCTATTCTA
CTTCGGCCGTCTAGGCATA -> TTCGGCCGTCTAGGCATAG
AAGTAGAGGTAAGTGACAT -> AGTAGAGGTAAGTGACATA
CATATTTATTCTTGGAGGG -> ATATTTATTCTTGGAGGGA
CACCTCCTTTTTAAGCATA -> ACCTCCTTTTTAAGCATAC
TCATAGAGATTACCATTTC -> CATAGAGATTACCATTTCG
CGCAACAGGAAGTTCTAGG -> GCAACAGGAAGTTCTAGGG
ATTAACAAGTAGCTTGTGC -> TTAACAAGTAGCTTGTGCA
CAGAAGTACGGTTCTCGAT -> AGAAGTACGGTTCTCGATC
GTAGAAGGGGGTGACGGGC -> TAGAAGGGGGTGACGGGCC
TAGGGTCATGTTGGAGACT -> AGGGTCATGTTGGAGACTT
CTGCACGAGTGTATCGGTT -> TGCACGAGTGTATCGGTTC
CACGATGCACCCCACAGAA -> ACGATGCACCCCACAGAAG
TAAGGTGTAGAAGCAATGG -> AAGGTGTAGAAGCAATGGC
CAGCGATTGTACAACGAGT -> AGCGATTGTACAACGAGTA
GAGATGTGACAAGTGGTTC -> AGATGTGACAAGTGGTTCG
CGCGCGCTCTCTAATAGAC -> GCGCGCTCTCTAATAGACA
TACGATTAATGAGCCTGCG -> ACGATTAATGAGCCTGCGG
CCCCGAGTCGCCCAGGCCA -> CCCGAGTCGCCCAGGCCAC
GCGGTCACACGTAACCCGC -> CGGTCACACGTAACCCGCT
TAACTGATTATTACTATTA -> AACTGATTATTACTATTAC
GTACAACGAGTAGCGTCGC -> TACAACGAGTAGCGTCGCA
GTGGCGTCACCACAAAGAT -> TGGCGTCACCACAAAGATC
ATTTTTAGTTTTATAAGTG -> TTTTTAGTTTTATAAGTGT
AAAGCTGATATGGCGGTCC -> AAGCTGATATGGCGGTCCA
ATGATACTGGATGCACGGA -> TGATACTGGATGCACGGAC
CTGGACCAACCCTGTATGG -> TGGACCAACCCTGTATGGT
AAGTGATATACCAATATTT -> AGTGATATACCAATATTTC
GACCCCCCACCCGCCGAAG -> ACCCCCCACCCGCCGAAGT
CTATATTGCCGCTGGTGAA -> TATATTGCCGCTGGTGAAC
CCAAAGCTGATATGGCGGT -> CAAAGCTGATATGGCGGTC
GCAAATTCAAGGTGACAAG -> CAAATTCAAGGTGACAAGT
ATGTTGGAGACTTCAACCG -> TGTTGGAGACTTCAACCGT
AGCGGTCACACGTAACCCG -> GCGGTCACACGTAACCCGC
TTATTCTTGGAGGGAGATC -> TATTCTTGGAGGGAGATCC
GAATAAGCGGCAACGAGCA -> AATAAGCGGCAACGAGCAC
GAGGTGGATCCATTGTGAG -> AGGTGGATCCATTGTGAGG
ACGAGTAGCGTCGCATGTA -> CGAGTAGCGTCGCATGTAA
GGACGGAACGAGTAAAATA -> GACGGAACGAGTAAAATAC
GCTAGCCGGTGGCCGTTAC -> CTAGCCGGTGGCCGTTACA
GTGGATCCATTGTGAGGCG -> TGGATCCATTGTGAGGCGA
TGCCGTATTAGCTGCCCCG -> GCCGTATTAGCTGCCCCGA
GCCCAGCGTGGACGGAACG -> CCCAGCGTGGACGGAACGA
ATCGGCTCTCCGGGATTAG -> TCGGCTCTCCGGGATTAGA
CCACAGAAGTACGGTTCTC -> CACAGAAGTACGGTTCTCG
GTTTAGCTTACGATGATAC -> TTTAGCTTACGATGATACT
GCTCAAGATAATTGACCTG -> CTCAAGATAATTGACCTGA
AACCATAAGTCGTCACGCG -> ACCATAAGTCGTCACGCGG
ACCTGAAGCAGACTTCGGC -> CCTGAAGCAGACTTCGGCC
GATACTGGATGCACGGACT -> ATACTGGATGCACGGACTT
TCAGCTAGCCGGTGGCCGT -> CAGCTAGCCGGTGGCCGTT
GCGATCATAGAGATTACCA -> CGATCATAGAGATTACCAT
TCACGTGGTCGTCCCGCGT -> CACGTGGTCGTCCCGCGTC
TCTTTATTGTACTAAACAA -> CTTTATTGTACTAAACAAC
GCATTCTACGCGCTCCCCC -> CATTCTACGCGCTCCCCCA
GGAGACTTCAACCGTCTCT -> GAGACTTCAACCGTCTCTT
TACTCTCAAGCCGCCCTTG -> ACTCTCAAGCCGCCCTTGA
ACCATTTCGCGTCGCTGCA -> CCATTTCGCGTCGCTGCAC
TTACGATGATACTGGAAAG -> TACGATGATACTGGAAAGG
CGTGCCCGGCTACAGCACG -> GTGCCCGGCTACAGCACGC
TTATAAGTGTTGGTATTGA -> TATAAGTGTTGGTATTGAC
TCTAATAGACATGGGGTCA -> CTAATAGACATGGGGTCAC
TGACTTTCTAACGAATACA -> GACTTTCTAACGAATACAA
ATATTTCATCAGTGCTCTG -> TATTTCATCAGTGCTCTGA
TCCAGTGCCGCAGACTACA -> CCAGTGCCGCAGACTACAT
CTCTCCGGGATTAGAAGCA -> TCTCCGGGATTAGAAGCAG
AAGTATTGGTCTAGTGGCG -> AGTATTGGTCTAGTGGCGC
GCGTCGCATGTAAGCCATT -> CGTCGCATGTAAGCCATTT
AGTCGCCCAGGCCACGCTT -> GTCGCCCAGGCCACGCTTA
GATTAACCCGAGCATATCC -> ATTAACCCGAGCATATCCG
TCGCTCGCACAACTCAAAG -> CGCTCGCACAACTCAAAGC
ATAAAAAAGTGGCCCAGCG -> TAAAAAAGTGGCCCAGCGT
ACGATACTGACCCCGGCCC -> CGATACTGACCCCGGCCCC
GCGGCTTACCGATTAAGGA -> CGGCTTACCGATTAAGGAG
ACAAGTATAACGGAAATTC -> CAAGTATAACGGAAATTCA
GACTCTATGGTTCGGTGAC -> ACTCTATGGTTCGGTGACC
GAGCCCTGCGGTTGATTTA -> AGCCCTGCGGTTGATTTAT
AATTCAAGGTGACAAGTAT -> ATTCAAGGTGACAAGTATA
TTTTAGTTTTATAAGTGTT -> TTTAGTTTTATAAGTGTTG
ACGATGCACCCCACAGAAG -> CGATGCACCCCACAGAAGT
CCTAACCATAAGTCGTCAC -> CTAACCATAAGTCGTCACG
ACACCCCGCCCGACGATCG -> CACCCCGCCCGACGATCGC
GGTCTGGGATGGCTTCCTG -> GTCTGGGATGGCTTCCTGA
CGTCTCTTGATGGAGGGAG -> GTCTCTTGATGGAGGGAGT
ACTAAGGTGTAGAAGCAAT -> CTAAGGTGTAGAAGCAATG
CGAGATAGATTAACCCGAG -> GAGATAGATTAACCCGAGC
CTTACGATGATACTGGAGA -> TTACGATGATACTGGAGAT
GGCCCAGCGTGGACGGAAC -> GCCCAGCGTGGACGGAACG
TGTAATCAGCCCTAGTGTC -> GTAATCAGCCCTAGTGTCT
ATTCAAGGTGACAAGTATA -> TTCAAGGTGACAAGTATAA
GTTACGGTGTCCTCCCCCC -> TTACGGTGTCCTCCCCCCG
AGTATTGGTCTAGTGGCGC -> GTATTGGTCTAGTGGCGCC
CTGAAGCAGACTTCGGCCG -> TGAAGCAGACTTCGGCCGT
GTGTAAGTCCAAAGCTGAT -> TGTAAGTCCAAAGCTGATA
AGATGCCTACCGAAGGTTT -> GATGCCTACCGAAGGTTTA
TGGAAAGGGACTCTATGGT -> GGAAAGGGACTCTATGGTT
GAGTGTATCGGTTCGTCGA -> AGTGTATCGGTTCGTCGAT
TCTCGGCTTACGATGATAC -> CTCGGCTTACGATGATACT
TATATTGCCGCTGGTGAAC -> ATATTGCCGCTGGTGAACA
TAAGTCGTCACGCGGAGCC -> AAGTCGTCACGCGGAGCCC
CCCCCAGTAGGGTCGTCAA -> CCCCAGTAGGGTCGTCAAA
TCTCTCCTGAGCCGGGTCT -> CTCTCCTGAGCCGGGTCTG
CAGATGCCTACCGAAGGTT -> AGATGCCTACCGAAGGTTT
TGGAGACTTCAACCGTCTC -> GGAGACTTCAACCGTCTCT
TGACCTGATGAGCACTCTA -> GACCTGATGAGCACTCTAT
TGTACAACGAGTAGCGTCG -> GTACAACGAGTAGCGTCGC
CGGGTTTGGGCAAGTAATT -> GGGTTTGGGCAAGTAATTT
ACTTTCGCATGCACCTTAT -> CTTTCGCATGCACCTTATA
CCCGACTGCAATGGTGCGT -> CCGACTGCAATGGTGCGTT
GTAACATTTGGTCTCTTTC -> TAACATTTGGTCTCTTTCC
TCTAGCGTCAGTGCTTACG -> CTAGCGTCAGTGCTTACGA
TAGGGTCGTCAAAACTCGC -> AGGGTCGTCAAAACTCGCA
AGACCCCCCAGTTTTTCCA -> GACCCCCCAGTTTTTCCAG
TTACTATTACTCTCAAGCC -> TACTATTACTCTCAAGCCG
TTGATTTATCTAGCGTCAG -> TGATTTATCTAGCGTCAGT
GATGTGACAAGTGGTTCGG -> ATGTGACAAGTGGTTCGGT
AGCTTGTGCACAAAGAACA -> GCTTGTGCACAAAGAACAG
GGAACGAGTAAAATACGAT -> GAACGAGTAAAATACGATA
GTGAACAATAGCCTGCGAC -> TGAACAATAGCCTGCGACA
CGGTGACCCCGACTGCAAT -> GGTGACCCCGACTGCAATG
GTTCCGATTGTGGTCAGCT -> TTCCGATTGTGGTCAGCTA
TATACCAATATTTCATCAG -> ATACCAATATTTCATCAGT
AGAATAAGCGGCAACGAGC -> GAATAAGCGGCAACGAGCA
TCCGACATCGAGTAAGTGG -> CCGACATCGAGTAAGTGGT
CTAAGGTGTAGAAGCAATG -> TAAGGTGTAGAAGCAATGG
CGTGCATATTCAGAATAAG -> GTGCATATTCAGAATAAGC
TTACGATGATACTGGATGC -> TACGATGATACTGGATGCA
TCAAAGCCGCAGATGGTAA -> CAAAGCCGCAGATGGTAAC
CTATACTGCTGCCACTCTT -> TATACTGCTGCCACTCTTT
TCATCAGTGCTCTGATAGA -> CATCAGTGCTCTGATAGAC
TATTAGCTGCCCCGAGTCG -> ATTAGCTGCCCCGAGTCGC
TGCGGCTTACCGATTAAGG -> GCGGCTTACCGATTAAGGA
GCCCTGCGGTTGATTTATC -> CCCTGCGGTTGATTTATCT
AATATTTCATCAGTGCTCT -> ATATTTCATCAGTGCTCTG
TCTCAGACTTTCGCATGCA -> CTCAGACTTTCGCATGCAC
GTCGTCCCGCGTCAAGTAT -> TCGTCCCGCGTCAAGTATT
TTTAAACTCCAAGTGATAT -> TTAAACTCCAAGTGATATA
CGGTAGACTAAGGTGTAGA -> GGTAGACTAAGGTGTAGAA
AGAAGGGGGTGACGGGCCA -> GAAGGGGGTGACGGGCCAA
TTAATGAGCCTGCGGCTTA -> TAATGAGCCTGCGGCTTAC
AAGCCGCCCTTGAGTATTT -> AGCCGCCCTTGAGTATTTT
CATTGTGAGGCGAAGCCGG -> ATTGTGAGGCGAAGCCGGT
CCCGTTCCCTTTCCTTGAA -> CCGTTCCCTTTCCTTGAAT
GGCCCCCTGTATCTGCCTC -> GCCCCCTGTATCTGCCTCG
AAGATATTTTTAGTTTTAT -> AGATATTTTTAGTTTTATA
GGTTCGGTGACCCCGACTC -> GTTCGGTGACCCCGACTCA,GTTCGGTGACCCCGACTCT
ATTAGTATCTCTAGTCGCA -> TTAGTATCTCTAGTCGCAT
CCTGCGGTTGATTTATCTA -> CTGCGGTTGATTTATCTAG
AGGGAGTAGACCCCCCAGT -> GGGAGTAGACCCCCCAGTT
CCACAAAGATCGCTCGCAC -> CACAAAGATCGCTCGCACA
ATAGGCACGCGCGCTCTCT -> TAGGCACGCGCGCTCTCTA
CTGGATGCACGGACTTTGG -> TGGATGCACGGACTTTGGT
GCAAGTAGAGGTAAGTGAC -> CAAGTAGAGGTAAGTGACA
GTGACCCCGACTTGGCGTG -> TGACCCCGACTTGGCGTGT
GCGATTGTACAACGAGTAG -> CGATTGTACAACGAGTAGC
TTAGCAATCCTCGTAGCCG -> TAGCAATCCTCGTAGCCGA
GTACACATAATGTGCGAGC -> TACACATAATGTGCGAGCC
TATCCGACATCGAGTAAGT -> ATCCGACATCGAGTAAGTG
TAACCCGCTCGGAGCGATC -> AACCCGCTCGGAGCGATCA
GATGATACTGGATGCACGG -> ATGATACTGGATGCACGGA
ATCTCACGATGCACCCCAC -> TCTCACGATGCACCCCACA
AGCAAATTTTTAAACTCCA -> GCAAATTTTTAAACTCCAA
ATCTCTGGACCACCTCAAC -> TCTCTGGACCACCTCAACA
ATCTGCCTCGCCCGTTCCC -> TCTGCCTCGCCCGTTCCCT
TCTCTTGATGGAGGGAGTA -> CTCTTGATGGAGGGAGTAG
GATCGCTCGCACAACTCAA -> ATCGCTCGCACAACTCAAA
ACCTCCTTTTTAAGCATAC -> CCTCCTTTTTAAGCATACG
CAGTTTTTCCAGATGCCTA -> AGTTTTTCCAGATGCCTAC
TCACACGTAACCCGCTCGG -> CACACGTAACCCGCTCGGA
AGTTATGTCGGTAGACTAA -> GTTATGTCGGTAGACTAAG
AGACTACATCGAGACAAGC -> GACTACATCGAGACAAGCT
CATAGACTATACTGCTGCC -> ATAGACTATACTGCTGCCA
GGCTTACGATGATACTGGA -> GCTTACGATGATACTGGAG
TGTACTAAACAACGAAATC -> GTACTAAACAACGAAATCA
GAGGTCCTTGCAAGTAGAG -> AGGTCCTTGCAAGTAGAGG
AGCCGAAGCAGCTCTAGCC -> GCCGAAGCAGCTCTAGCCA
TGAACAATAGCCTGCGACA -> GAACAATAGCCTGCGACAT
ATGCGGGATTGCCGTTAGG -> TGCGGGATTGCCGTTAGGG
AAGCAGCGATTGTACAACG -> AGCAGCGATTGTACAACGA
TGATTTATCTAGCGTCAGT -> GATTTATCTAGCGTCAGTG
AAACCGTGCATATTCAGAA -> AACCGTGCATATTCAGAAT
TTAGTATCTCTAGTCGCAT -> TAGTATCTCTAGTCGCATT
CCCACAGAAGTACGGTTCT -> CCACAGAAGTACGGTTCTC
CACGCGCGCTCTCTAATAG -> ACGCGCGCTCTCTAATAGA
CTCTTGATGGAGGGAGTAG -> TCTTGATGGAGGGAGTAGA
TGCTCTGATAGACGTGCCC -> GCTCTGATAGACGTGCCCG
GTCGCATGTAAGCCATTTA -> TCGCATGTAAGCCATTTAG
GTTTTTCCAGATGCCTACC -> TTTTTCCAGATGCCTACCG
CTGCTGCCACTCTTTAAGC -> TGCTGCCACTCTTTAAGCA
TCTCTAATAGACATGGGGT -> CTCTAATAGACATGGGGTC
GGCGCCGTTCTTTATTGTA -> GCGCCGTTCTTTATTGTAC
ATCAAACGCTATGGCCACG -> TCAAACGCTATGGCCACGG
CAGCTCTAGCCATCTCAGG -> AGCTCTAGCCATCTCAGGC
AAGGAGGTCCTTGCAAGTA -> AGGAGGTCCTTGCAAGTAG
CAGTGCCGCAGACTACATC -> AGTGCCGCAGACTACATCG
AAAAAAGTGGCCCAGCGTG -> AAAAAGTGGCCCAGCGTGG
AGCAGCGATTGTACAACGA -> GCAGCGATTGTACAACGAG
TAATAGACATGGGGTCACC -> AATAGACATGGGGTCACCT
CACTCGTCTATGTTTATTA -> ACTCGTCTATGTTTATTAG
AGACTTCGGCCGTCTAGGC -> GACTTCGGCCGTCTAGGCA
AAGTTTAGCTTACGATGAT -> AGTTTAGCTTACGATGATA
AAAGTGGCCCAGCGTGGAC -> AAGTGGCCCAGCGTGGACG
TATGTTAACTACGATGCGG -> ATGTTAACTACGATGCGGG
TATCTCTAGTCGCATTATT -> ATCTCTAGTCGCATTATTA
GAGTAGCGTCGCATGTAAG -> AGTAGCGTCGCATGTAAGC
GACAATTCTCTCCTGAGCC -> ACAATTCTCTCCTGAGCCG
GCGTGTAAGTCCAAAGCTG -> CGTGTAAGTCCAAAGCTGA
AGCACCTTGTAAGTTTAGC -> GCACCTTGTAAGTTTAGCT
ACCCCGACTCTCAGACTTT -> CCCCGACTCTCAGACTTTC
ACGGAGTCCTATTCTATTG -> CGGAGTCCTATTCTATTGG
CCCGGCCCCCTGTATCTGC -> CCGGCCCCCTGTATCTGCC
ATCAGTGCTCTGATAGACG -> TCAGTGCTCTGATAGACGT
TGATACTGGAAAGGGACTC -> GATACTGGAAAGGGACTCT
GGAAGTTCTAGGGTCATGT -> GAAGTTCTAGGGTCATGTT
ACCGATTAAGGAGGTCCTT -> CCGATTAAGGAGGTCCTTG
AGATTACCATTTCGCGTCG -> GATTACCATTTCGCGTCGC
TTTGGTCTCTTTCCGGGAA -> TTGGTCTCTTTCCGGGAAA
GATATTCACATATTTATTC -> ATATTCACATATTTATTCT
TGGTAACTGATTATTACTA -> GGTAACTGATTATTACTAT
GCACTCTATCTCACGATGC -> CACTCTATCTCACGATGCA
TAAGGAGGTCCTTGCAAGT -> AAGGAGGTCCTTGCAAGTA
CTAAACAACGAAATCACCC -> 
AGAGATATTCACATATTTA -> GAGATATTCACATATTTAT
GCTCTCCGGGATTAGAAGC -> CTCTCCGGGATTAGAAGCA
GACCCCGACTCAGAGGTGG -> ACCCCGACTCAGAGGTGGA
CCTCGCCCGTTCCCTTTCC -> CTCGCCCGTTCCCTTTCCT
GGCTTCCTGACTATGTTAA -> GCTTCCTGACTATGTTAAC
CGATGATACTGGATGCACG -> GATGATACTGGATGCACGG
GGCCGTCTAGGCATAGCGA -> GCCGTCTAGGCATAGCGAC
CGACTGCAATGGTGCGTTC -> GACTGCAATGGTGCGTTCC
CCAGCGTGGACGGAACGAG -> CAGCGTGGACGGAACGAGT
CCATCTCAGGCTGTGACTT -> CATCTCAGGCTGTGACTTT
CTGATATGGCGGTCCAGTG -> TGATATGGCGGTCCAGTGC
GGAGGTCCTTGCAAGTAGA -> GAGGTCCTTGCAAGTAGAG
CCACCCGCCGAAGTACAGT -> CACCCGCCGAAGTACAGTT
TTGCAAGTAGAGGTAAGTG -> TGCAAGTAGAGGTAAGTGA
CTGATTATTACTATTACTC -> TGATTATTACTATTACTCT
GAGATAGATTAACCCGAGC -> AGATAGATTAACCCGAGCA
TTCATCAGTGCTCTGATAG -> TCATCAGTGCTCTGATAGA
TTTAGCTTACGATGATACT -> TTAGCTTACGATGATACTG
GCAATGGCTAGTAACATTT -> CAATGGCTAGTAACATTTG
CGATCTCTGGACCACCTCA -> GATCTCTGGACCACCTCAA
CCCGCCCGACGATCGCTGC -> CCGCCCGACGATCGCTGCC
TGTTCGATCACATCAAACG -> GTTCGATCACATCAAACGC
ACAACTCAAAGCCGCAGAT -> CAACTCAAAGCCGCAGATG
CAATTCTCTCCTGAGCCGG -> AATTCTCTCCTGAGCCGGG
CGGTCACACGTAACCCGCT -> GGTCACACGTAACCCGCTC
GATGCACCCCACAGAAGTA -> ATGCACCCCACAGAAGTAC
CAACAGGAAGTTCTAGGGT -> AACAGGAAGTTCTAGGGTC
GCTGGATCACGTGGTCGTC -> CTGGATCACGTGGTCGTCC
AAGTAGCTTGTGCACAAAG -> AGTAGCTTGTGCACAAAGA
CGGTGACCCCGACTCTCAG -> GGTGACCCCGACTCTCAGA
TGACTATGTTAACTACGAT -> GACTATGTTAACTACGATG
TAGCTTGTGCACAAAGAAC -> AGCTTGTGCACAAAGAACA
GCTTACGATGATACTGGAG -> CTTACGATGATACTGGAGA
TCCTTTTTAAGCATACGAT -> CCTTTTTAAGCATACGATT
CCCGACGATCGCTGCCGTA -> CCGACGATCGCTGCCGTAT
GTCACCTGGCGCTCAAGAT -> TCACCTGGCGCTCAAGATA
TCAATGTAATCAGCCCTAG -> CAATGTAATCAGCCCTAGT
CCGCCGAAGTACAGTTATG -> CGCCGAAGTACAGTTATGT
GGCACACTGTGTTCGATCA -> GCACACTGTGTTCGATCAC
TAGCAAATTCAAGGTGACA -> AGCAAATTCAAGGTGACAA
CGACAATTCTCTCCTGAGC -> GACAATTCTCTCCTGAGCC
TCTCTGGACCACCTCAACA -> CTCTGGACCACCTCAACAA
CCTGAGCCGGGTCTGGGAT -> CTGAGCCGGGTCTGGGATG
TATACTGCTGCCACTCTTT -> ATACTGCTGCCACTCTTTA
CAAGTGGTTCGGTGACCCC -> AAGTGGTTCGGTGACCCCG
AGCACTCGTCTATGTTTAT -> GCACTCGTCTATGTTTATT
GGTCTCTTTCCGGGAAATA -> GTCTCTTTCCGGGAAATAA
AATGGCTAGTAACATTTGG -> ATGGCTAGTAACATTTGGT
GTCTGGGATGGCTTCCTGA -> TCTGGGATGGCTTCCTGAC
GATCTCTGGACCACCTCAA -> ATCTCTGGACCACCTCAAC
CTCAAGATAATTGACCTGA -> TCAAGATAATTGACCTGAA
CAGCCCTAGTGTCTGTAAA -> AGCCCTAGTGTCTGTAAAT
TCCTCCCCCCGCATTCTAC -> CCTCCCCCCGCATTCTACG
CCCTTGAGTATTTTTCGAT -> CCTTGAGTATTTTTCGATC
CGCATTATTAACAAGTAGC -> GCATTATTAACAAGTAGCT
TCGGTGACCCCGACTCTCA -> CGGTGACCCCGACTCTCAG
TAGACTAAGGTGTAGAAGC -> AGACTAAGGTGTAGAAGCA
GTATAGTAAAACCGTGCAT -> TATAGTAAAACCGTGCATA
CTCAGACTTTCGCATGCAC -> TCAGACTTTCGCATGCACC
CTGATAGACGTGCCCGGCT -> TGATAGACGTGCCCGGCTA
TGGATCCATTGTGAGGCGA -> GGATCCATTGTGAGGCGAA
CGTGGTCGTCCCGCGTCAA -> GTGGTCGTCCCGCGTCAAG
GATCCATTGTGAGGCGAAG -> ATCCATTGTGAGGCGAAGC
AACTCGCAACAGGAAGTTC -> ACTCGCAACAGGAAGTTCT
CGTTCCGATTGTGGTCAGC -> GTTCCGATTGTGGTCAGCT
TTAAGCATACGATTAATGA -> TAAGCATACGATTAATGAG
ACAATTCTCTCCTGAGCCG -> CAATTCTCTCCTGAGCCGG
CGATCACATCAAACGCTAT -> GATCACATCAAACGCTATG
CAAAACTCGCAACAGGAAG -> AAAACTCGCAACAGGAAGT
ATACTGGACCAACCCTGTA -> TACTGGACCAACCCTGTAT
CGTGTAAGTCCAAAGCTGA -> GTGTAAGTCCAAAGCTGAT
TGATGGAGGGAGTAGACCC -> GATGGAGGGAGTAGACCCC
CACGCTTACGATGATACTG -> ACGCTTACGATGATACTGG
GTCAAGTATTGGTCTAGTG -> TCAAGTATTGGTCTAGTGG
CGGTTCGTCGATTTTCGAG -> GGTTCGTCGATTTTCGAGA
GCCCGTTCCCTTTCCTTGA -> CCCGTTCCCTTTCCTTGAA
TAGAGATATTCACATATTT -> AGAGATATTCACATATTTA
TATGTTTATTAGTATCTCT -> ATGTTTATTAGTATCTCTA
ATTAATGAGCCTGCGGCTT -> TTAATGAGCCTGCGGCTTA
GTCGATTTTCGAGAGACCG -> TCGATTTTCGAGAGACCGG
CACATCAAACGCTATGGCC -> ACATCAAACGCTATGGCCA
CGATTAATGAGCCTGCGGC -> GATTAATGAGCCTGCGGCT
TGCGACATACGGGTCTCGG -> GCGACATACGGGTCTCGGC
AACAGGAAGTTCTAGGGTC -> ACAGGAAGTTCTAGGGTCA
TCTATGTTTATTAGTATCT -> CTATGTTTATTAGTATCTC
CTGGCGCTCAAGATAATTG -> TGGCGCTCAAGATAATTGA
TTGTGCACAAAGAACAGAA -> TGTGCACAAAGAACAGAAG
GTGCTCTGATAGACGTGCC -> TGCTCTGATAGACGTGCCC
ACGGAACGAGTAAAATACG -> CGGAACGAGTAAAATACGA
TTTTTAGTTTTATAAGTGT -> TTTTAGTTTTATAAGTGTT
TAGTTCTAAATTACCCGAG -> AGTTCTAAATTACCCGAGA
CTCAGAGGTGGATCCATTG -> TCAGAGGTGGATCCATTGT
AGTACAGTTATGTCGGTAG -> GTACAGTTATGTCGGTAGA
GTGACTTTCTAACGAATAC -> TGACTTTCTAACGAATACA
GATAGGCACACTGTGTTCG -> ATAGGCACACTGTGTTCGA
GGATGCACGGACTTTGGTT -> GATGCACGGACTTTGGTTC
ACCCCCCAGTTTTTCCAGA -> CCCCCCAGTTTTTCCAGAT
TGCCTCGCCCGTTCCCTTT -> GCCTCGCCCGTTCCCTTTC
GTTCGGTGACCCCGACTCA -> TTCGGTGACCCCGACTCAG
CACTGTGTTCGATCACATC -> ACTGTGTTCGATCACATCA
TGTCCTCCCCCCGCATTCT -> GTCCTCCCCCCGCATTCTA
ACGATGCGGGATTGCCGTT -> CGATGCGGGATTGCCGTTA
GACAAGTGGTTCGGTGACC -> ACAAGTGGTTCGGTGACCC
CGAGCCGAAGCAGCTCTAG -> GAGCCGAAGCAGCTCTAGC
GGGGTCACCTCCTTTTTAA -> GGGTCACCTCCTTTTTAAG
CCCGCATTCTACGCGCTCC -> CCGCATTCTACGCGCTCCC
TCTTGGAGGGAGATCCTGA -> CTTGGAGGGAGATCCTGAT
GAAGCAGCTCTAGCCATCT -> AAGCAGCTCTAGCCATCTC
GCCACTCTTTAAGCAAATT -> CCACTCTTTAAGCAAATTT
GGAGTAGACCCCCCAGTTT -> GAGTAGACCCCCCAGTTTT
CGGCAACGAGCACTCGTCT -> GGCAACGAGCACTCGTCTA
GCACCCCACAGAAGTACGG -> CACCCCACAGAAGTACGGT
ATATTCAGAATAAGCGGCA -> TATTCAGAATAAGCGGCAA
GCCGTTCTTTATTGTACTA -> CCGTTCTTTATTGTACTAA
CCCCGCATTCTACGCGCTC -> CCCGCATTCTACGCGCTCC
TCGTAGCCGAAGCGTAAAG -> CGTAGCCGAAGCGTAAAGA
CTGGACCACCTCAACAACA -> TGGACCACCTCAACAACAA
GCCGAAGCAGCTCTAGCCA -> CCGAAGCAGCTCTAGCCAT
ATTGACCTGAAGCAGACTT -> TTGACCTGAAGCAGACTTC
GGTCCAGTGCCGCAGACTA -> GTCCAGTGCCGCAGACTAC
AAGGTGACAAGTATAACGG -> AGGTGACAAGTATAACGGA
CCGGGTCTGGGATGGCTTC -> CGGGTCTGGGATGGCTTCC
TATTTATTCTTGGAGGGAG -> ATTTATTCTTGGAGGGAGA
CAGAGGTGGATCCATTGTG -> AGAGGTGGATCCATTGTGA
AAGAGATATATAGGCACGC -> AGAGATATATAGGCACGCG
CGCCGCCACGACAATTCTC -> GCCGCCACGACAATTCTCT
CCGTTACACCCCGCCCGAC -> CGTTACACCCCGCCCGACG
TGGCCCAGCGTGGACGGAA -> GGCCCAGCGTGGACGGAAC
GCTCGGAGCGATCATAGAG -> CTCGGAGCGATCATAGAGA
CATTCTACGCGCTCCCCCA -> ATTCTACGCGCTCCCCCAG
CCAACCCTGTATGGTTCGG -> CAACCCTGTATGGTTCGGT
GTATAACGGAAATTCAATG -> TATAACGGAAATTCAATGT
GATCGCTGCCGTATTAGCT -> ATCGCTGCCGTATTAGCTG
ATTTCATCAGTGCTCTGAT -> TTTCATCAGTGCTCTGATA
CGCATTCTACGCGCTCCCC -> GCATTCTACGCGCTCCCCC
GATGATACTGGAGATGTGA -> ATGATACTGGAGATGTGAC
CGACTCAGAGGTGGATCCA -> GACTCAGAGGTGGATCCAT
AAACGCTATGGCCACGGAG -> AACGCTATGGCCACGGAGT
CATATTCAGAATAAGCGGC -> ATATTCAGAATAAGCGGCA
TCTCAGGCTGTGACTTTCT -> CTCAGGCTGTGACTTTCTA
GCTCTCTAATAGACATGGG -> CTCTCTAATAGACATGGGG
ACATAGACGCCGAGATAGA -> CATAGACGCCGAGATAGAT
AAATTCAATGTAATCAGCC -> AATTCAATGTAATCAGCCC
TACAATACTAGTTAAGCTC -> ACAATACTAGTTAAGCTCG
CTAGTGTCTGTAAATATCG -> TAGTGTCTGTAAATATCGG
GCGAGCCGAAGCAGCTCTA -> CGAGCCGAAGCAGCTCTAG
ATAAGTCGTCACGCGGAGC -> TAAGTCGTCACGCGGAGCC
TGGCTAGTAACATTTGGTC -> GGCTAGTAACATTTGGTCT
GTCCAGAACGTTACGGTGT -> TCCAGAACGTTACGGTGTC
TTCTATTGGTACACATAAT -> TCTATTGGTACACATAATG
CGCTCTCTAATAGACATGG -> GCTCTCTAATAGACATGGG
TCCTTGCAAGTAGAGGTAA -> CCTTGCAAGTAGAGGTAAG
GTTTGGGCAAGTAATTTCA -> TTTGGGCAAGTAATTTCAC
GACGCCGAGATAGATTAAC -> ACGCCGAGATAGATTAACC
ACGATCGCTGCCGTATTAG -> CGATCGCTGCCGTATTAGC
GTCGCCCAGGCCACGCTTA -> TCGCCCAGGCCACGCTTAC
ATCATAGAGATTACCATTT -> TCATAGAGATTACCATTTC
TCAACAACAAGATGGATTC -> CAACAACAAGATGGATTCG
CTCTATCTCACGATGCACC -> TCTATCTCACGATGCACCC
CGCACGGTCCAGAACGTTA -> GCACGGTCCAGAACGTTAC
AACTCAAAGCCGCAGATGG -> ACTCAAAGCCGCAGATGGT
GCAGACTACATCGAGACAA -> CAGACTACATCGAGACAAG
TGTCGGTAGACTAAGGTGT -> GTCGGTAGACTAAGGTGTA
GAGACTTCAACCGTCTCTT -> AGACTTCAACCGTCTCTTG
CACGAGTGTATCGGTTCGT -> ACGAGTGTATCGGTTCGTC
CAACCGTCTCTTGATGGAG -> AACCGTCTCTTGATGGAGG
TCGCACAACTCAAAGCCGC -> CGCACAACTCAAAGCCGCA
TCCGGGAAATAAAAAAGTG -> CCGGGAAATAAAAAAGTGG
AAAATACGATACTGACCCC -> AAATACGATACTGACCCCG
TATAACGGAAATTCAATGT -> ATAACGGAAATTCAATGTA
GGAGCGATCATAGAGATTA -> GAGCGATCATAGAGATTAC
ATCACATCAAACGCTATGG -> TCACATCAAACGCTATGGC
CGGTCCAGAACGTTACGGT -> GGTCCAGAACGTTACGGTG
GTTGGAGACTTCAACCGTC -> TTGGAGACTTCAACCGTCT
TTCGGTGACCCCGACTCAG -> TCGGTGACCCCGACTCAGA
TATTGGTACACATAATGTG -> ATTGGTACACATAATGTGC
ACGTTACGGTGTCCTCCCC -> CGTTACGGTGTCCTCCCCC
GGAGATGTGACAAGTGGTT -> GAGATGTGACAAGTGGTTC
CATCGAGACAAGCTAGTAG -> ATCGAGACAAGCTAGTAGA
CATATCCGACATCGAGTAA -> ATATCCGACATCGAGTAAG
AGGCGAAGCCGGTGGCGTC -> GGCGAAGCCGGTGGCGTCA
CCGCTCGGAGCGATCATAG -> CGCTCGGAGCGATCATAGA
TAGATTAACCCGAGCATAT -> AGATTAACCCGAGCATATC
TTGACCTGATGAGCACTCT -> TGACCTGATGAGCACTCTA
GCCGCAGACTACATCGAGA -> CCGCAGACTACATCGAGAC
CTAGCCATCTCAGGCTGTG -> TAGCCATCTCAGGCTGTGA
CCAAGTGATATACCAATAT -> CAAGTGATATACCAATATT
TGTAAGTCCAAAGCTGATA -> GTAAGTCCAAAGCTGATAT
GCTAGTAGAAGGGGGTGAC -> CTAGTAGAAGGGGGTGACG
ACTGCAATGGTGCGTTCCG -> CTGCAATGGTGCGTTCCGA
AGGCACGCGCGCTCTCTAA -> GGCACGCGCGCTCTCTAAT
GCTACAGCACGCCGCCACG -> CTACAGCACGCCGCCACGA
GCATACGATTAATGAGCCT -> CATACGATTAATGAGCCTG
AAAGGGACTCTATGGTTCG -> AAGGGACTCTATGGTTCGG
CCCCTGTATCTGCCTCGCC -> CCCTGTATCTGCCTCGCCC
CGAGTAAGTGGTCACCTGG -> GAGTAAGTGGTCACCTGGC
TTCTACGCGCTCCCCCAGT -> TCTACGCGCTCCCCCAGTA
CTGAGCCGGGTCTGGGATG -> TGAGCCGGGTCTGGGATGG
AGCGATTGTACAACGAGTA -> GCGATTGTACAACGAGTAG
CTTGTGCACAAAGAACAGA -> TTGTGCACAAAGAACAGAA
AAGCGTAAAGATATTTTTA -> AGCGTAAAGATATTTTTAG
AGGTGGATCCATTGTGAGG -> GGTGGATCCATTGTGAGGC
CAAATTTTTAAACTCCAAG -> AAATTTTTAAACTCCAAGT
CTAGTCGCATTATTAACAA -> TAGTCGCATTATTAACAAG
GACCAACCCTGTATGGTTC -> ACCAACCCTGTATGGTTCG
GAGACCGGGTTTGGGCAAG -> AGACCGGGTTTGGGCAAGT
TCGGCCGTCTAGGCATAGC -> CGGCCGTCTAGGCATAGCG
GCGGTCCAGTGCCGCAGAC -> CGGTCCAGTGCCGCAGACT
ACTACGATGCGGGATTGCC -> CTACGATGCGGGATTGCCG
TACTGACCCCGGCCCCCTG -> ACTGACCCCGGCCCCCTGT
TCGAGTAAGTGGTCACCTG -> CGAGTAAGTGGTCACCTGG
GCCCGACGATCGCTGCCGT -> CCCGACGATCGCTGCCGTA
CGTCGCTGCACGAGTGTAT -> GTCGCTGCACGAGTGTATC
ATTTTCGAGAGACCGGGTT -> TTTTCGAGAGACCGGGTTT
CACAGAAGTACGGTTCTCG -> ACAGAAGTACGGTTCTCGA
GTGGTCAGCTAGCCGGTGG -> TGGTCAGCTAGCCGGTGGC
ACATTTGGTCTCTTTCCGG -> CATTTGGTCTCTTTCCGGG
ACACGTAACCCGCTCGGAG -> CACGTAACCCGCTCGGAGC
ACCTGGCGCTCAAGATAAT -> CCTGGCGCTCAAGATAATT
ATGTAAGCCATTTAGCTAG -> TGTAAGCCATTTAGCTAGT
ATAGATTAACCCGAGCATA -> TAGATTAACCCGAGCATAT
CCTGATAGGCACACTGTGT -> CTGATAGGCACACTGTGTT
GGCATAGCGACCCCCCACC -> GCATAGCGACCCCCCACCC
CCGACTCTCAGACTTTCGC -> CGACTCTCAGACTTTCGCA
CTTGAATGTGCTGGATCAC -> TTGAATGTGCTGGATCACG
CCGGTGGCGTCACCACAAA -> CGGTGGCGTCACCACAAAG
AAGCGGCAACGAGCACTCG -> AGCGGCAACGAGCACTCGT
CTCGTAGCCGAAGCGTAAA -> TCGTAGCCGAAGCGTAAAG
GCGCTCAAGATAATTGACC -> CGCTCAAGATAATTGACCT
TTATTAACAAGTAGCTTGT -> TATTAACAAGTAGCTTGTG
AGATGGTAACTGATTATTA -> GATGGTAACTGATTATTAC
GGTTCGGTGACCCCGACTG -> GTTCGGTGACCCCGACTGC
GGCAACGAGCACTCGTCTA -> GCAACGAGCACTCGTCTAT
GCGGCAACGAGCACTCGTC -> CGGCAACGAGCACTCGTCT
CCCCGACTCAGAGGTGGAT -> CCCGACTCAGAGGTGGATC
TAAGCATACGATTAATGAG -> AAGCATACGATTAATGAGC
TTAGTTTTATAAGTGTTGG -> TAGTTTTATAAGTGTTGGT
CCGGGTTTGGGCAAGTAAT -> CGGGTTTGGGCAAGTAATT
ACAAAGATCGCTCGCACAA -> CAAAGATCGCTCGCACAAC
CCTGCGGCTTACCGATTAA -> CTGCGGCTTACCGATTAAG
GCGTTTAGCAATCCTCGTA -> CGTTTAGCAATCCTCGTAG
CCCGCCGAAGTACAGTTAT -> CCGCCGAAGTACAGTTATG
GCGCTCCCCCAGTAGGGTC -> CGCTCCCCCAGTAGGGTCG
CACGACAATTCTCTCCTGA -> ACGACAATTCTCTCCTGAG
CACGGTCCAGAACGTTACG -> ACGGTCCAGAACGTTACGG
TGGTATTGACCTGATGAGC -> GGTATTGACCTGATGAGCA
AAACTCGCAACAGGAAGTT -> AACTCGCAACAGGAAGTTC
ATAGAGATTACCATTTCGC -> TAGAGATTACCATTTCGCG
ACACTGGGTATAGTAAAAC -> CACTGGGTATAGTAAAACC
TGATATGGCGGTCCAGTGC -> GATATGGCGGTCCAGTGCC
CGTCCCGCGTCAAGTATTG -> GTCCCGCGTCAAGTATTGG
CCCTTTCCTTGAATGTGCT -> CCTTTCCTTGAATGTGCTG
CTATGGCCACGGAGTCCTA -> TATGGCCACGGAGTCCTAT
AGAGACCGGGTTTGGGCAA -> GAGACCGGGTTTGGGCAAG
GTTCGGTGACCCCGACTTG -> TTCGGTGACCCCGACTTGG
CAGTGCTCTGATAGACGTG -> AGTGCTCTGATAGACGTGC
GAGTATTTTTCGATCTCTG -> AGTATTTTTCGATCTCTGG
TGTAGAAGCAATGGCTAGT -> GTAGAAGCAATGGCTAGTA
GGTTCGGTGACCCCGACTT -> GTTCGGTGACCCCGACTTG
TAGAAGCAATGGCTAGTAA -> AGAAGCAATGGCTAGTAAC
AAGGCTATATTGCCGCTGG -> AGGCTATATTGCCGCTGGT
TCTAAATTACCCGAGAGTT -> CTAAATTACCCGAGAGTTA
GAATGTGCTGGATCACGTG -> AATGTGCTGGATCACGTGG
TGCTTACGATGATACTGGA -> GCTTACGATGATACTGGAT
AGACTTTCGCATGCACCTT -> GACTTTCGCATGCACCTTA
GCACCTTGTAAGTTTAGCT -> CACCTTGTAAGTTTAGCTT
CGGGTCTCGGCTTACGATG -> GGGTCTCGGCTTACGATGA
CCCCCCAGTTTTTCCAGAT -> CCCCCAGTTTTTCCAGATG
AAGCCATTTAGCTAGTTCT -> AGCCATTTAGCTAGTTCTA
TCTCCGGGATTAGAAGCAG -> CTCCGGGATTAGAAGCAGC
ATTCAGAATAAGCGGCAAC -> TTCAGAATAAGCGGCAACG
TTCAATGTAATCAGCCCTA -> TCAATGTAATCAGCCCTAG
GCAACAGGAAGTTCTAGGG -> CAACAGGAAGTTCTAGGGT
TTTCGATCTCTGGACCACC -> TTCGATCTCTGGACCACCT
CAAGGTGACAAGTATAACG -> AAGGTGACAAGTATAACGG
TGGACCACCTCAACAACAA -> GGACCACCTCAACAACAAG
ACAGTTATGTCGGTAGACT -> CAGTTATGTCGGTAGACTA
CCACGACAATTCTCTCCTG -> CACGACAATTCTCTCCTGA
GAGGTAAGTGACATAGACG -> AGGTAAGTGACATAGACGC
TGAGGCGAAGCCGGTGGCG -> GAGGCGAAGCCGGTGGCGT
GCCCAGGCCACGCTTACGA -> CCCAGGCCACGCTTACGAT
TCGTCGATTTTCGAGAGAC -> CGTCGATTTTCGAGAGACC
GAGACAAGCTAGTAGAAGG -> AGACAAGCTAGTAGAAGGG
GTGCTTACGATGATACTGG -> TGCTTACGATGATACTGGA
TGAAGCAGACTTCGGCCGT -> GAAGCAGACTTCGGCCGTC
GACCCCGACTCTCAGACTT -> ACCCCGACTCTCAGACTTT
ACTCTCAGACTTTCGCATG -> CTCTCAGACTTTCGCATGC
AGATTAACCCGAGCATATC -> GATTAACCCGAGCATATCC
AGGGTCGTCAAAACTCGCA -> GGGTCGTCAAAACTCGCAA
CATGGGGTCACCTCCTTTT -> ATGGGGTCACCTCCTTTTT
CCTATTCTATTGGTACACA -> CTATTCTATTGGTACACAT
ATGCCTACCGAAGGTTTAG -> TGCCTACCGAAGGTTTAGA
GTGGACGGAACGAGTAAAA -> TGGACGGAACGAGTAAAAT
ATCCTCGTAGCCGAAGCGT -> TCCTCGTAGCCGAAGCGTA
CTAGTAGAAGGGGGTGACG -> TAGTAGAAGGGGGTGACGG
ACTTCGGCCGTCTAGGCAT -> CTTCGGCCGTCTAGGCATA
TAAATTACCCGAGAGTTAG -> AAATTACCCGAGAGTTAGA
CTTTAAGCAAATTTTTAAA -> TTTAAGCAAATTTTTAAAC
GGGATTAGAAGCAGCGATT -> GGATTAGAAGCAGCGATTG
GTATGGTTCGGTGACCCCG -> TATGGTTCGGTGACCCCGA
TAGTTAAGCTCGGCGTTTA -> AGTTAAGCTCGGCGTTTAG
GATCCTGATAGGCACACTG -> ATCCTGATAGGCACACTGT
AGTGGCGCCGTTCTTTATT -> GTGGCGCCGTTCTTTATTG
TGGACCAACCCTGTATGGT -> GGACCAACCCTGTATGGTT
CACGGACTTTGGTTCGGTG -> ACGGACTTTGGTTCGGTGA
TTCTAACACACTGGGTATA -> TCTAACACACTGGGTATAG
TGGTCACCTGGCGCTCAAG -> GGTCACCTGGCGCTCAAGA
TCTGCCTCGCCCGTTCCCT -> CTGCCTCGCCCGTTCCCTT
TAACCCGAGCATATCCGAC -> AACCCGAGCATATCCGACA
ACTGGACCAACCCTGTATG -> CTGGACCAACCCTGTATGG
TCAAACGCTATGGCCACGG -> CAAACGCTATGGCCACGGA
CACTCTATCTCACGATGCA -> ACTCTATCTCACGATGCAC
TGTGACTTTCTAACGAATA -> GTGACTTTCTAACGAATAC
CTATGGTTCGGTGACCCCG -> TATGGTTCGGTGACCCCGA
TTCACTTAGCACCTTGTAA -> TCACTTAGCACCTTGTAAG
CTCTGGACCACCTCAACAA -> TCTGGACCACCTCAACAAC
CGTCAAGTATTGGTCTAGT -> GTCAAGTATTGGTCTAGTG
CTAGGCATAGCGACCCCCC -> TAGGCATAGCGACCCCCCA
TTTTTAAGCATACGATTAA -> TTTTAAGCATACGATTAAT
GTTTAGAGATATTCACATA -> TTTAGAGATATTCACATAT
CCCGACTTGGCGTGTAAGT -> CCGACTTGGCGTGTAAGTC
GGGTTTGGGCAAGTAATTT -> GGTTTGGGCAAGTAATTTC
CGCCCAGGCCACGCTTACG -> GCCCAGGCCACGCTTACGA
TTAAGCAAATTTTTAAACT -> TAAGCAAATTTTTAAACTC
GACCACCTCAACAACAAGA -> ACCACCTCAACAACAAGAT
CTCTCAAGCCGCCCTTGAG -> TCTCAAGCCGCCCTTGAGT
ATATATAGGCACGCGCGCT -> TATATAGGCACGCGCGCTC
ACTGGATGCACGGACTTTG -> CTGGATGCACGGACTTTGG
CCTTGTAAGTTTAGCTTAC -> CTTGTAAGTTTAGCTTACG
CCGCAGACTACATCGAGAC -> CGCAGACTACATCGAGACA
TCCTAACCATAAGTCGTCA -> CCTAACCATAAGTCGTCAC
AGTGGTCACCTGGCGCTCA -> GTGGTCACCTGGCGCTCAA
ATTCTACGCGCTCCCCCAG -> TTCTACGCGCTCCCCCAGT
CTGGAAAGGGACTCTATGG -> TGGAAAGGGACTCTATGGT
GGTCTAGTGGCGCCGTTCT -> GTCTAGTGGCGCCGTTCTT
CATACGGGTCTCGGCTTAC -> ATACGGGTCTCGGCTTACG
AGTGCTCTGATAGACGTGC -> GTGCTCTGATAGACGTGCC
CGATGATACTGGAAAGGGA -> GATGATACTGGAAAGGGAC
TTTCCAGATGCCTACCGAA -> TTCCAGATGCCTACCGAAG
TAACGGAAATTCAATGTAA -> AACGGAAATTCAATGTAAT
CTTACCGATTAAGGAGGTC -> TTACCGATTAAGGAGGTCC
TAAGTTTAGCTTACGATGA -> AAGTTTAGCTTACGATGAT
CAAGTATTGGTCTAGTGGC -> AAGTATTGGTCTAGTGGCG
AGTTTTTCCAGATGCCTAC -> GTTTTTCCAGATGCCTACC
CGCGTCAAGTATTGGTCTA -> GCGTCAAGTATTGGTCTAG
GTCACCTCCTTTTTAAGCA -> TCACCTCCTTTTTAAGCAT
TTAGCTAGTTCTAAATTAC -> TAGCTAGTTCTAAATTACC
GGTCCTTGCAAGTAGAGGT -> GTCCTTGCAAGTAGAGGTA
GGATGGCTTCCTGACTATG -> GATGGCTTCCTGACTATGT
GGGAGTAGACCCCCCAGTT -> GGAGTAGACCCCCCAGTTT
TACGATGATACTGGAAAGG -> ACGATGATACTGGAAAGGG
TTTTCGATCTCTGGACCAC -> TTTCGATCTCTGGACCACC
AGCCATTTAGCTAGTTCTA -> GCCATTTAGCTAGTTCTAA
TGATACTGGACCAACCCTG -> GATACTGGACCAACCCTGT
TCTAGCCATCTCAGGCTGT -> CTAGCCATCTCAGGCTGTG
CGCCCGTTCCCTTTCCTTG -> GCCCGTTCCCTTTCCTTGA
GCTTACGATGATACTGGAA -> CTTACGATGATACTGGAAA
TCCCTTTCCTTGAATGTGC -> CCCTTTCCTTGAATGTGCT
GAGCCGAAGCAGCTCTAGC -> AGCCGAAGCAGCTCTAGCC
CTTTCCGGGAAATAAAAAA -> TTTCCGGGAAATAAAAAAG
AGATATTTTTAGTTTTATA -> GATATTTTTAGTTTTATAA
ATAAGTGTTGGTATTGACC -> TAAGTGTTGGTATTGACCT
CTTAGCACCTTGTAAGTTT -> TTAGCACCTTGTAAGTTTA
GATTGTACAACGAGTAGCG -> ATTGTACAACGAGTAGCGT
GACAAGTATAACGGAAATT -> ACAAGTATAACGGAAATTC
GCTGATATGGCGGTCCAGT -> CTGATATGGCGGTCCAGTG
CGCTTACGATGATACTGGA -> GCTTACGATGATACTGGAC
GATCACGTGGTCGTCCCGC -> ATCACGTGGTCGTCCCGCG
ATGTTTATTAGTATCTCTA -> TGTTTATTAGTATCTCTAG
CGTAGCCGAAGCGTAAAGA -> GTAGCCGAAGCGTAAAGAT
GCTAGTAACATTTGGTCTC -> CTAGTAACATTTGGTCTCT
GAGATATTCACATATTTAT -> AGATATTCACATATTTATT
TGTGGTCAGCTAGCCGGTG -> GTGGTCAGCTAGCCGGTGG
CAAATTCAAGGTGACAAGT -> AAATTCAAGGTGACAAGTA
AGACGTGCCCGGCTACAGC -> GACGTGCCCGGCTACAGCA
CCTTTTTAAGCATACGATT -> CTTTTTAAGCATACGATTA
AAGTGACATAGACGCCGAG -> AGTGACATAGACGCCGAGA
TGTTGGTATTGACCTGATG -> GTTGGTATTGACCTGATGA
AAGAACAGAAGAGATATAT -> AGAACAGAAGAGATATATA
TCCTGACTATGTTAACTAC -> CCTGACTATGTTAACTACG
CATCGAGTAAGTGGTCACC -> ATCGAGTAAGTGGTCACCT
CAGATGGTAACTGATTATT -> AGATGGTAACTGATTATTA
TATCGGTTCGTCGATTTTC -> ATCGGTTCGTCGATTTTCG
CGTATTAGCTGCCCCGAGT -> GTATTAGCTGCCCCGAGTC
GCAGCGATTGTACAACGAG -> CAGCGATTGTACAACGAGT
GGGTCGTCAAAACTCGCAA -> GGTCGTCAAAACTCGCAAC
GTTAACTACGATGCGGGAT -> TTAACTACGATGCGGGATT
GGATTGCCGTTAGGGTTTC -> GATTGCCGTTAGGGTTTCT
GGCTCTCCGGGATTAGAAG -> GCTCTCCGGGATTAGAAGC
TACCGAAGGTTTAGAGATA -> ACCGAAGGTTTAGAGATAT
TACGGTGTCCTCCCCCCGC -> ACGGTGTCCTCCCCCCGCA
CGATTGTGGTCAGCTAGCC -> GATTGTGGTCAGCTAGCCG
TAGTAGAAGGGGGTGACGG -> AGTAGAAGGGGGTGACGGG
AAATTCAAGGTGACAAGTA -> AATTCAAGGTGACAAGTAT
GCCTCGCCCGTTCCCTTTC -> CCTCGCCCGTTCCCTTTCC
CTGCGGTTGATTTATCTAG -> TGCGGTTGATTTATCTAGC
ATAATGTGCGAGCCGAAGC -> TAATGTGCGAGCCGAAGCA
AAGCTGATATGGCGGTCCA -> AGCTGATATGGCGGTCCAG
GTACTAAACAACGAAATCA -> TACTAAACAACGAAATCAC
CCGGTGGCCGTTACACCCC -> CGGTGGCCGTTACACCCCG
CGTGGACGGAACGAGTAAA -> GTGGACGGAACGAGTAAAA
GCTATATTGCCGCTGGTGA -> CTATATTGCCGCTGGTGAA
TTTTCGAGAGACCGGGTTT -> TTTCGAGAGACCGGGTTTG
ATCACGTGGTCGTCCCGCG -> TCACGTGGTCGTCCCGCGT
TTAACCCGAGCATATCCGA -> TAACCCGAGCATATCCGAC
GACTGCAATGGTGCGTTCC -> ACTGCAATGGTGCGTTCCG
CGAAGTACAGTTATGTCGG -> GAAGTACAGTTATGTCGGT
AGTGACATAGACGCCGAGA -> GTGACATAGACGCCGAGAT
CATAGAGATTACCATTTCG -> ATAGAGATTACCATTTCGC
ATGCACCTTATAGCAAATT -> TGCACCTTATAGCAAATTC
GCCGCCACGACAATTCTCT -> CCGCCACGACAATTCTCTC
AAAGAACAGAAGAGATATA -> AAGAACAGAAGAGATATAT
AACTCCAAGTGATATACCA -> ACTCCAAGTGATATACCAA
CCCTGTATCTGCCTCGCCC -> CCTGTATCTGCCTCGCCCG
CGCGGAGCCCTGCGGTTGA -> GCGGAGCCCTGCGGTTGAT
CCGTTCCCTTTCCTTGAAT -> CGTTCCCTTTCCTTGAATG
CCGCCACGACAATTCTCTC -> CGCCACGACAATTCTCTCC
TCTCGATCCTAACCATAAG -> CTCGATCCTAACCATAAGT
GATGGCTTCCTGACTATGT -> ATGGCTTCCTGACTATGTT
TGTGCGAGCCGAAGCAGCT -> GTGCGAGCCGAAGCAGCTC
CGGTGTCCTCCCCCCGCAT -> GGTGTCCTCCCCCCGCATT
TTTCATCAGTGCTCTGATA -> TTCATCAGTGCTCTGATAG
TGCGTTCCGATTGTGGTCA -> GCGTTCCGATTGTGGTCAG
TCACTTAGCACCTTGTAAG -> CACTTAGCACCTTGTAAGT
CTCGCAACAGGAAGTTCTA -> TCGCAACAGGAAGTTCTAG
GAGTCGCCCAGGCCACGCT -> AGTCGCCCAGGCCACGCTT
ATAGCAAATTCAAGGTGAC -> TAGCAAATTCAAGGTGACA
ACCTTGTAAGTTTAGCTTA -> CCTTGTAAGTTTAGCTTAC
GACTTTCTAACGAATACAA -> ACTTTCTAACGAATACAAT
ATAATTGACCTGAAGCAGA -> TAATTGACCTGAAGCAGAC
AACCCGAGCATATCCGACA -> ACCCGAGCATATCCGACAT
CGATCATAGAGATTACCAT -> GATCATAGAGATTACCATT
ATAAGCGGCAACGAGCACT -> TAAGCGGCAACGAGCACTC
CGCTCAAGATAATTGACCT -> GCTCAAGATAATTGACCTG
AATCAGCCCTAGTGTCTGT -> ATCAGCCCTAGTGTCTGTA
AATTGACCTGAAGCAGACT -> ATTGACCTGAAGCAGACTT
TAGCGTCAGTGCTTACGAT -> AGCGTCAGTGCTTACGATG
CGCGCTCCCCCAGTAGGGT -> GCGCTCCCCCAGTAGGGTC
AGTAGAGGTAAGTGACATA -> GTAGAGGTAAGTGACATAG
ATTACTATTACTCTCAAGC -> TTACTATTACTCTCAAGCC
CCAATATTTCATCAGTGCT -> CAATATTTCATCAGTGCTC
ATACTGACCCCGGCCCCCT -> TACTGACCCCGGCCCCCTG
GCTTGTGCACAAAGAACAG -> CTTGTGCACAAAGAACAGA
CTCAACAACAAGATGGATT -> TCAACAACAAGATGGATTC
ATTAACCCGAGCATATCCG -> TTAACCCGAGCATATCCGA
ACCCCGACTTGGCGTGTAA -> CCCCGACTTGGCGTGTAAG
TGCGGTTGATTTATCTAGC -> GCGGTTGATTTATCTAGCG
GAGATATATAGGCACGCGC -> AGATATATAGGCACGCGCG
GGTGACAAGTATAACGGAA -> GTGACAAGTATAACGGAAA
TCAGAGGTGGATCCATTGT -> CAGAGGTGGATCCATTGTG
GGTAACTGATTATTACTAT -> GTAACTGATTATTACTATT
GTTACACCCCGCCCGACGA -> TTACACCCCGCCCGACGAT
TAACATTTGGTCTCTTTCC -> AACATTTGGTCTCTTTCCG
AAAAAGTGGCCCAGCGTGG -> AAAAGTGGCCCAGCGTGGA
TATTTTTAGTTTTATAAGT -> ATTTTTAGTTTTATAAGTG
ATGGTGCGTTCCGATTGTG -> TGGTGCGTTCCGATTGTGG
TCACATATTTATTCTTGGA -> CACATATTTATTCTTGGAG
TCGCCCAGGCCACGCTTAC -> CGCCCAGGCCACGCTTACG
GCTGCCACTCTTTAAGCAA -> CTGCCACTCTTTAAGCAAA
GCCGCTGGTGAACAATAGC -> CCGCTGGTGAACAATAGCC
ATTGCCGTTAGGGTTTCTA -> TTGCCGTTAGGGTTTCTAA
TTGTGGTCAGCTAGCCGGT -> TGTGGTCAGCTAGCCGGTG
CTTTATTGTACTAAACAAC -> TTTATTGTACTAAACAACG
ATCCTAACCATAAGTCGTC -> TCCTAACCATAAGTCGTCA
ACAGCACGCCGCCACGACA -> CAGCACGCCGCCACGACAA
CCAGTTTTTCCAGATGCCT -> CAGTTTTTCCAGATGCCTA
ATTGTACTAAACAACGAAA -> TTGTACTAAACAACGAAAT
CTACAGCACGCCGCCACGA -> TACAGCACGCCGCCACGAC
TGCACCCCACAGAAGTACG -> GCACCCCACAGAAGTACGG
CTTTCTAACGAATACAATA -> TTTCTAACGAATACAATAC
TTAAACTCCAAGTGATATA -> TAAACTCCAAGTGATATAC
TCGGTGACCCCGACTGCAA -> CGGTGACCCCGACTGCAAT
TATAGGCACGCGCGCTCTC -> ATAGGCACGCGCGCTCTCT
ATTTCACTTAGCACCTTGT -> TTTCACTTAGCACCTTGTA
CAGTGCTTACGATGATACT -> AGTGCTTACGATGATACTG
TGGAGGGAGTAGACCCCCC -> GGAGGGAGTAGACCCCCCA
CTACGCGCTCCCCCAGTAG -> TACGCGCTCCCCCAGTAGG
CACTTAGCACCTTGTAAGT -> ACTTAGCACCTTGTAAGTT
GATACTGGAAAGGGACTCT -> ATACTGGAAAGGGACTCTA
TGTATCGGTTCGTCGATTT -> GTATCGGTTCGTCGATTTT
GACCCCGGCCCCCTGTATC -> ACCCCGGCCCCCTGTATCT
AAGCGGTCACACGTAACCC -> AGCGGTCACACGTAACCCG
GGGCAAGTAATTTCACTTA -> GGCAAGTAATTTCACTTAG
CACACTGGGTATAGTAAAA -> ACACTGGGTATAGTAAAAC
GTTCTCGATCCTAACCATA -> TTCTCGATCCTAACCATAA
TAAAAAAGTGGCCCAGCGT -> AAAAAAGTGGCCCAGCGTG
TACCGATTAAGGAGGTCCT -> ACCGATTAAGGAGGTCCTT
TGGGCAAGTAATTTCACTT -> GGGCAAGTAATTTCACTTA
CGGAACGAGTAAAATACGA -> GGAACGAGTAAAATACGAT
TATTACTATTACTCTCAAG -> ATTACTATTACTCTCAAGC
TCTCACGATGCACCCCACA -> CTCACGATGCACCCCACAG
GTGAGGCGAAGCCGGTGGC -> TGAGGCGAAGCCGGTGGCG
AAGGGGGTGACGGGCCAAG -> AGGGGGTGACGGGCCAAGG
TCTAGTGGCGCCGTTCTTT -> CTAGTGGCGCCGTTCTTTA
CTCCCCCAGTAGGGTCGTC -> TCCCCCAGTAGGGTCGTCA
GCCGTATTAGCTGCCCCGA -> CCGTATTAGCTGCCCCGAG
TCGCTGCCGTATTAGCTGC -> CGCTGCCGTATTAGCTGCC
GTGACATAGACGCCGAGAT -> TGACATAGACGCCGAGATA
CGATACTGACCCCGGCCCC -> GATACTGACCCCGGCCCCC
TTACGATGATACTGGAGAT -> TACGATGATACTGGAGATG
GACATGGGGTCACCTCCTT -> ACATGGGGTCACCTCCTTT
AGATATTCACATATTTATT -> GATATTCACATATTTATTC
TTTCACTTAGCACCTTGTA -> TTCACTTAGCACCTTGTAA
GTAATTTCACTTAGCACCT -> TAATTTCACTTAGCACCTT
CTTCCTGACTATGTTAACT -> TTCCTGACTATGTTAACTA
ACACATAATGTGCGAGCCG -> CACATAATGTGCGAGCCGA
CCCGAGTCGCCCAGGCCAC -> CCGAGTCGCCCAGGCCACG
GGTGACGGGCCAAGGCTAT -> GTGACGGGCCAAGGCTATA
ATATTTTTAGTTTTATAAG -> TATTTTTAGTTTTATAAGT
AGCTGATATGGCGGTCCAG -> GCTGATATGGCGGTCCAGT
CCGTTAGGGTTTCTAACAC -> CGTTAGGGTTTCTAACACA
TTCTTGGAGGGAGATCCTG -> TCTTGGAGGGAGATCCTGA
CGAGCACTCGTCTATGTTT -> GAGCACTCGTCTATGTTTA
ACGTAACCCGCTCGGAGCG -> CGTAACCCGCTCGGAGCGA
GGTCCAGAACGTTACGGTG -> GTCCAGAACGTTACGGTGT
CTCCGGGATTAGAAGCAGC -> TCCGGGATTAGAAGCAGCG
CAGTAGGGTCGTCAAAACT -> AGTAGGGTCGTCAAAACTC
TTTAAGCATACGATTAATG -> TTAAGCATACGATTAATGA
TGGCGCTCAAGATAATTGA -> GGCGCTCAAGATAATTGAC
TACGATGCGGGATTGCCGT -> ACGATGCGGGATTGCCGTT
ACCCCGACTCAGAGGTGGA -> CCCCGACTCAGAGGTGGAT
CTAACACACTGGGTATAGT -> TAACACACTGGGTATAGTA
TACTGGAGATGTGACAAGT -> ACTGGAGATGTGACAAGTG
AATAGCCTGCGACATACGG -> ATAGCCTGCGACATACGGG
ATAGACTATACTGCTGCCA -> TAGACTATACTGCTGCCAC
TGGTTCGGTGACCCCGACT -> GGTTCGGTGACCCCGACTC,GGTTCGGTGACCCCGACTC,GGTTCGGTGACCCCGACTT,GGTTCGGTGACCCCGACTG
GCATATTCAGAATAAGCGG -> CATATTCAGAATAAGCGGC
CAGTTATGTCGGTAGACTA -> AGTTATGTCGGTAGACTAA
TTTTTCGATCTCTGGACCA -> TTTTCGATCTCTGGACCAC
CCGAAGTACAGTTATGTCG -> CGAAGTACAGTTATGTCGG
CGATGATACTGGACCAACC -> GATGATACTGGACCAACCC
CACACTGTGTTCGATCACA -> ACACTGTGTTCGATCACAT
CTCGGCTTACGATGATACT -> TCGGCTTACGATGATACTG
GACCCCGACTGCAATGGTG -> ACCCCGACTGCAATGGTGC
TTCCGATTGTGGTCAGCTA -> TCCGATTGTGGTCAGCTAG
ACTTCAACCGTCTCTTGAT -> CTTCAACCGTCTCTTGATG
GTAAATATCGGCTCTCCGG -> TAAATATCGGCTCTCCGGG
ACGATGATACTGGACCAAC -> CGATGATACTGGACCAACC
TACACCCCGCCCGACGATC -> ACACCCCGCCCGACGATCG
CAATCCTCGTAGCCGAAGC -> AATCCTCGTAGCCGAAGCG
ATGGGGTCACCTCCTTTTT -> TGGGGTCACCTCCTTTTTA
ATTTTTAAACTCCAAGTGA -> TTTTTAAACTCCAAGTGAT
CACCACAAAGATCGCTCGC -> ACCACAAAGATCGCTCGCA
GCCCGCACGGTCCAGAACG -> CCCGCACGGTCCAGAACGT
ACTTTCTAACGAATACAAT -> CTTTCTAACGAATACAATA
TGGATTCGCCCGCACGGTC -> GGATTCGCCCGCACGGTCC
ATATCGGCTCTCCGGGATT -> TATCGGCTCTCCGGGATTA
CCGTGCATATTCAGAATAA -> CGTGCATATTCAGAATAAG
ATCCATTGTGAGGCGAAGC -> TCCATTGTGAGGCGAAGCC
AAGTCCAAAGCTGATATGG -> AGTCCAAAGCTGATATGGC
GGGAAATAAAAAAGTGGCC -> GGAAATAAAAAAGTGGCCC
CTGTATCTGCCTCGCCCGT -> TGTATCTGCCTCGCCCGTT
ATCAGCCCTAGTGTCTGTA -> TCAGCCCTAGTGTCTGTAA
TAGCCGAAGCGTAAAGATA -> AGCCGAAGCGTAAAGATAT
AGGTTTAGAGATATTCACA -> GGTTTAGAGATATTCACAT
TAAGTGTTGGTATTGACCT -> AAGTGTTGGTATTGACCTG
TGTGCTGGATCACGTGGTC -> GTGCTGGATCACGTGGTCG
GCCATTTAGCTAGTTCTAA -> CCATTTAGCTAGTTCTAAA
TTACGATGATACTGGACCA -> TACGATGATACTGGACCAA
AGGAGGTCCTTGCAAGTAG -> GGAGGTCCTTGCAAGTAGA
GATTAATGAGCCTGCGGCT -> ATTAATGAGCCTGCGGCTT
CTATGTTAACTACGATGCG -> TATGTTAACTACGATGCGG
TTATTACTATTACTCTCAA -> TATTACTATTACTCTCAAG
ATCTAGCGTCAGTGCTTAC -> TCTAGCGTCAGTGCTTACG
TGGCGCCGTTCTTTATTGT -> GGCGCCGTTCTTTATTGTA
CATAATGTGCGAGCCGAAG -> ATAATGTGCGAGCCGAAGC
GAGCACTCTATCTCACGAT -> AGCACTCTATCTCACGATG
AGCCTGCGACATACGGGTC -> GCCTGCGACATACGGGTCT
GCACGAGTGTATCGGTTCG -> CACGAGTGTATCGGTTCGT
TATCTGCCTCGCCCGTTCC -> ATCTGCCTCGCCCGTTCCC
GGGAGATCCTGATAGGCAC -> GGAGATCCTGATAGGCACA
ACCCCCCACCCGCCGAAGT -> CCCCCCACCCGCCGAAGTA
GACTTCAACCGTCTCTTGA -> ACTTCAACCGTCTCTTGAT
CGACGATCGCTGCCGTATT -> GACGATCGCTGCCGTATTA
GTAATCAGCCCTAGTGTCT -> TAATCAGCCCTAGTGTCTG
CTCGGCGTTTAGCAATCCT -> TCGGCGTTTAGCAATCCTC
AGGCACACTGTGTTCGATC -> GGCACACTGTGTTCGATCA
GTCATGTTGGAGACTTCAA -> TCATGTTGGAGACTTCAAC
TCTATTGGTACACATAATG -> CTATTGGTACACATAATGT
GGCCAAGGCTATATTGCCG -> GCCAAGGCTATATTGCCGC
ACAAGATGGATTCGCCCGC -> CAAGATGGATTCGCCCGCA
AGTTTAGCTTACGATGATA -> GTTTAGCTTACGATGATAC
ATGGCTAGTAACATTTGGT -> TGGCTAGTAACATTTGGTC
CCCTGCGGTTGATTTATCT -> CCTGCGGTTGATTTATCTA
TTTTTCCAGATGCCTACCG -> TTTTCCAGATGCCTACCGA
CGGTTGATTTATCTAGCGT -> GGTTGATTTATCTAGCGTC
CCCCCACCCGCCGAAGTAC -> CCCCACCCGCCGAAGTACA
TCACCTCCTTTTTAAGCAT -> CACCTCCTTTTTAAGCATA
GCTGTGACTTTCTAACGAA -> CTGTGACTTTCTAACGAAT
GGGTCTGGGATGGCTTCCT -> GGTCTGGGATGGCTTCCTG
ACGATTAATGAGCCTGCGG -> CGATTAATGAGCCTGCGGC
GCGTCGCTGCACGAGTGTA -> CGTCGCTGCACGAGTGTAT
TGCACGAGTGTATCGGTTC -> GCACGAGTGTATCGGTTCG
ATTCTTGGAGGGAGATCCT -> TTCTTGGAGGGAGATCCTG
GGCACGCGCGCTCTCTAAT -> GCACGCGCGCTCTCTAATA
ATACGATACTGACCCCGGC -> TACGATACTGACCCCGGCC
CCGAAGCGTAAAGATATTT -> CGAAGCGTAAAGATATTTT
CTGTATGGTTCGGTGACCC -> TGTATGGTTCGGTGACCCC
CTAGCCGGTGGCCGTTACA -> TAGCCGGTGGCCGTTACAC
GACTCTCAGACTTTCGCAT -> ACTCTCAGACTTTCGCATG
AACGAGCACTCGTCTATGT -> ACGAGCACTCGTCTATGTT
ATACAATACTAGTTAAGCT -> TACAATACTAGTTAAGCTC
ACTCGCAACAGGAAGTTCT -> CTCGCAACAGGAAGTTCTA
CGGAGCGATCATAGAGATT -> GGAGCGATCATAGAGATTA
AGTCCTATTCTATTGGTAC -> GTCCTATTCTATTGGTACA
GGTTCTCGATCCTAACCAT -> GTTCTCGATCCTAACCATA
GCGAAGCGGTCACACGTAA -> CGAAGCGGTCACACGTAAC
CCGTTCTTTATTGTACTAA -> CGTTCTTTATTGTACTAAA
GACTTTGGTTCGGTGACCC -> ACTTTGGTTCGGTGACCCC
GATCATAGACTATACTGCT -> ATCATAGACTATACTGCTG
TATCTCACGATGCACCCCA -> ATCTCACGATGCACCCCAC
ACCTCAACAACAAGATGGA -> CCTCAACAACAAGATGGAT
TTTTAAACTCCAAGTGATA -> TTTAAACTCCAAGTGATAT
TCGGTTCGTCGATTTTCGA -> CGGTTCGTCGATTTTCGAG
GGTAGACTAAGGTGTAGAA -> GTAGACTAAGGTGTAGAAG
GGTGACCCCGACTTGGCGT -> GTGACCCCGACTTGGCGTG
CCTGGCGCTCAAGATAATT -> CTGGCGCTCAAGATAATTG
ATAGCGACCCCCCACCCGC -> TAGCGACCCCCCACCCGCC
GCATTATTAACAAGTAGCT -> CATTATTAACAAGTAGCTT
GTGATATACCAATATTTCA -> TGATATACCAATATTTCAT
CCGTCTAGGCATAGCGACC -> CGTCTAGGCATAGCGACCC
AATTTTTAAACTCCAAGTG -> ATTTTTAAACTCCAAGTGA
CCCGGCTACAGCACGCCGC -> CCGGCTACAGCACGCCGCC
GGACCACCTCAACAACAAG -> GACCACCTCAACAACAAGA
TGATATACCAATATTTCAT -> GATATACCAATATTTCATC
TAGTAACATTTGGTCTCTT -> AGTAACATTTGGTCTCTTT
ACTTGGCGTGTAAGTCCAA -> CTTGGCGTGTAAGTCCAAA
CCCCGACTTGGCGTGTAAG -> CCCGACTTGGCGTGTAAGT
TGCGGGATTGCCGTTAGGG -> GCGGGATTGCCGTTAGGGT
TAGACGTGCCCGGCTACAG -> AGACGTGCCCGGCTACAGC
TGCCCCGAGTCGCCCAGGC -> GCCCCGAGTCGCCCAGGCC
CTATTCTATTGGTACACAT -> TATTCTATTGGTACACATA
CTTTCCTTGAATGTGCTGG -> TTTCCTTGAATGTGCTGGA
CACCCCGCCCGACGATCGC -> ACCCCGCCCGACGATCGCT
GTTCGGTGACCCCGACTGC -> TTCGGTGACCCCGACTGCA
CCCTAGTGTCTGTAAATAT -> CCTAGTGTCTGTAAATATC
ATTATTAACAAGTAGCTTG -> TTATTAACAAGTAGCTTGT
ATCATAGACTATACTGCTG -> TCATAGACTATACTGCTGC
TTTAGAGATATTCACATAT -> TTAGAGATATTCACATATT
TTAGCTTACGATGATACTG -> TAGCTTACGATGATACTGG
TCGCGTCGCTGCACGAGTG -> CGCGTCGCTGCACGAGTGT
AAAAGTGGCCCAGCGTGGA -> AAAGTGGCCCAGCGTGGAC
GGTGTCCTCCCCCCGCATT -> GTGTCCTCCCCCCGCATTC
GCACACTGTGTTCGATCAC -> CACACTGTGTTCGATCACA
CTGACCCCGGCCCCCTGTA -> TGACCCCGGCCCCCTGTAT
GTAAGTCCAAAGCTGATAT -> TAAGTCCAAAGCTGATATG
AAATTTTTAAACTCCAAGT -> AATTTTTAAACTCCAAGTG
GTATCTCTAGTCGCATTAT -> TATCTCTAGTCGCATTATT
TCCAAGTGATATACCAATA -> CCAAGTGATATACCAATAT
ACGAGTGTATCGGTTCGTC -> CGAGTGTATCGGTTCGTCG
TATAAGTGTTGGTATTGAC -> ATAAGTGTTGGTATTGACC
ACCAACCCTGTATGGTTCG -> CCAACCCTGTATGGTTCGG
CTCCTTTTTAAGCATACGA -> TCCTTTTTAAGCATACGAT
TTAGCTGCCCCGAGTCGCC -> TAGCTGCCCCGAGTCGCCC
TTCCAGATGCCTACCGAAG -> TCCAGATGCCTACCGAAGG
ACTTTGGTTCGGTGACCCC -> CTTTGGTTCGGTGACCCCG
TGTATGGTTCGGTGACCCC -> GTATGGTTCGGTGACCCCG
TATTACTCTCAAGCCGCCC -> ATTACTCTCAAGCCGCCCT
TGAGCACTCTATCTCACGA -> GAGCACTCTATCTCACGAT
ACGGTGTCCTCCCCCCGCA -> CGGTGTCCTCCCCCCGCAT
ATATTGCCGCTGGTGAACA -> TATTGCCGCTGGTGAACAA
CGCCGAAGTACAGTTATGT -> GCCGAAGTACAGTTATGTC
GAAAGGGACTCTATGGTTC -> AAAGGGACTCTATGGTTCG
GCCAAGGCTATATTGCCGC -> CCAAGGCTATATTGCCGCT
GTCGCATTATTAACAAGTA -> TCGCATTATTAACAAGTAG
TATGGCCACGGAGTCCTAT -> ATGGCCACGGAGTCCTATT
AGCGATCATAGAGATTACC -> GCGATCATAGAGATTACCA
ACAATAGCCTGCGACATAC -> CAATAGCCTGCGACATACG
AATACGATACTGACCCCGG -> ATACGATACTGACCCCGGC
AGCCTGCGGCTTACCGATT -> GCCTGCGGCTTACCGATTA
GCGCTCTCTAATAGACATG -> CGCTCTCTAATAGACATGG
TACACATAATGTGCGAGCC -> ACACATAATGTGCGAGCCG
AGTAACATTTGGTCTCTTT -> GTAACATTTGGTCTCTTTC
TGTTGGAGACTTCAACCGT -> GTTGGAGACTTCAACCGTC
GTATTTTTCGATCTCTGGA -> TATTTTTCGATCTCTGGAC
GGTGACCCCGACTCTCAGA -> GTGACCCCGACTCTCAGAC
AACGAGTAAAATACGATAC -> ACGAGTAAAATACGATACT
GCACGCCGCCACGACAATT -> CACGCCGCCACGACAATTC
CACGCCGCCACGACAATTC -> ACGCCGCCACGACAATTCT
GAGCACTCGTCTATGTTTA -> AGCACTCGTCTATGTTTAT
TGCCTACCGAAGGTTTAGA -> GCCTACCGAAGGTTTAGAG
GCAGATGGTAACTGATTAT -> CAGATGGTAACTGATTATT
CGTAAAGATATTTTTAGTT -> GTAAAGATATTTTTAGTTT
CGGCCGTCTAGGCATAGCG -> GGCCGTCTAGGCATAGCGA
CAACAAGATGGATTCGCCC -> AACAAGATGGATTCGCCCG
CCAGGCCACGCTTACGATG -> CAGGCCACGCTTACGATGA
GATCCTAACCATAAGTCGT -> ATCCTAACCATAAGTCGTC
GCCGAAGTACAGTTATGTC -> CCGAAGTACAGTTATGTCG
TGATACTGGAGATGTGACA -> GATACTGGAGATGTGACAA
TACGCGCTCCCCCAGTAGG -> ACGCGCTCCCCCAGTAGGG
CCCACCCGCCGAAGTACAG -> CCACCCGCCGAAGTACAGT
GGTACACATAATGTGCGAG -> GTACACATAATGTGCGAGC
TAAGTGACATAGACGCCGA -> AAGTGACATAGACGCCGAG
ACCCCACAGAAGTACGGTT -> CCCCACAGAAGTACGGTTC
TAGACCCCCCAGTTTTTCC -> AGACCCCCCAGTTTTTCCA
GGCGCTCAAGATAATTGAC -> GCGCTCAAGATAATTGACC
ACCTTATAGCAAATTCAAG -> CCTTATAGCAAATTCAAGG
CGATGCGGGATTGCCGTTA -> GATGCGGGATTGCCGTTAG
AGACAAGCTAGTAGAAGGG -> GACAAGCTAGTAGAAGGGG
GCTCCCCCAGTAGGGTCGT -> CTCCCCCAGTAGGGTCGTC
GGTTCGTCGATTTTCGAGA -> GTTCGTCGATTTTCGAGAG
GGTGTAGAAGCAATGGCTA -> GTGTAGAAGCAATGGCTAG
CCGAGCATATCCGACATCG -> CGAGCATATCCGACATCGA
AATAAGCGGCAACGAGCAC -> ATAAGCGGCAACGAGCACT
TCTATCTCACGATGCACCC -> CTATCTCACGATGCACCCC
GAGAGACCGGGTTTGGGCA -> AGAGACCGGGTTTGGGCAA
TAGAGGTAAGTGACATAGA -> AGAGGTAAGTGACATAGAC
GGTCGTCCCGCGTCAAGTA -> GTCGTCCCGCGTCAAGTAT
ACTCTTTAAGCAAATTTTT -> CTCTTTAAGCAAATTTTTA
ACAGAAGAGATATATAGGC -> CAGAAGAGATATATAGGCA
GCGACATACGGGTCTCGGC -> CGACATACGGGTCTCGGCT
GCGTCAGTGCTTACGATGA -> CGTCAGTGCTTACGATGAT
CCCCGCCCGACGATCGCTG -> CCCGCCCGACGATCGCTGC
GTGCCCGGCTACAGCACGC -> TGCCCGGCTACAGCACGCC
AGCATATCCGACATCGAGT -> GCATATCCGACATCGAGTA
CTGGGATGGCTTCCTGACT -> TGGGATGGCTTCCTGACTA
CCGTATTAGCTGCCCCGAG -> CGTATTAGCTGCCCCGAGT
CACAAAGATCGCTCGCACA -> ACAAAGATCGCTCGCACAA
CGCTCGGAGCGATCATAGA -> GCTCGGAGCGATCATAGAG
TAATCAGCCCTAGTGTCTG -> AATCAGCCCTAGTGTCTGT
CACCTGGCGCTCAAGATAA -> ACCTGGCGCTCAAGATAAT
CATCTCAGGCTGTGACTTT -> ATCTCAGGCTGTGACTTTC
TGATAGGCACACTGTGTTC -> GATAGGCACACTGTGTTCG
GCCCTTGAGTATTTTTCGA -> CCCTTGAGTATTTTTCGAT
GATGGAGGGAGTAGACCCC -> ATGGAGGGAGTAGACCCCC
TTAACAAGTAGCTTGTGCA -> TAACAAGTAGCTTGTGCAC
CCCCGACTCTCAGACTTTC -> CCCGACTCTCAGACTTTCG
GACGGAACGAGTAAAATAC -> ACGGAACGAGTAAAATACG
CCGCGTCAAGTATTGGTCT -> CGCGTCAAGTATTGGTCTA
TCCAGAACGTTACGGTGTC -> CCAGAACGTTACGGTGTCC
ATGTGCGAGCCGAAGCAGC -> TGTGCGAGCCGAAGCAGCT
TGACAAGTGGTTCGGTGAC -> GACAAGTGGTTCGGTGACC
CCGCCCGACGATCGCTGCC -> CGCCCGACGATCGCTGCCG
TGACGGGCCAAGGCTATAT -> GACGGGCCAAGGCTATATT
CGGGATTAGAAGCAGCGAT -> GGGATTAGAAGCAGCGATT
CGGTGACCCCGACTTGGCG -> GGTGACCCCGACTTGGCGT
TAAACTCCAAGTGATATAC -> AAACTCCAAGTGATATACC
GAGTAAAATACGATACTGA -> AGTAAAATACGATACTGAC
ATTCTCTCCTGAGCCGGGT -> TTCTCTCCTGAGCCGGGTC
CACTCTTTAAGCAAATTTT -> ACTCTTTAAGCAAATTTTT
TAGCGTCGCATGTAAGCCA -> AGCGTCGCATGTAAGCCAT
GATGATACTGGACCAACCC -> ATGATACTGGACCAACCCT
GCCACGCTTACGATGATAC -> CCACGCTTACGATGATACT
TCGTCAAAACTCGCAACAG -> CGTCAAAACTCGCAACAGG
CTGGGTATAGTAAAACCGT -> TGGGTATAGTAAAACCGTG
GTATCTGCCTCGCCCGTTC -> TATCTGCCTCGCCCGTTCC
TCCTGAGCCGGGTCTGGGA -> CCTGAGCCGGGTCTGGGAT
GATTACCATTTCGCGTCGC -> ATTACCATTTCGCGTCGCT
AGAGTTAGATCATAGACTA -> GAGTTAGATCATAGACTAT
TGGCCACGGAGTCCTATTC -> GGCCACGGAGTCCTATTCT
ACCCTGTATGGTTCGGTGA -> CCCTGTATGGTTCGGTGAC
TTACCGATTAAGGAGGTCC -> TACCGATTAAGGAGGTCCT
CGTCAAAACTCGCAACAGG -> GTCAAAACTCGCAACAGGA
GGGTATAGTAAAACCGTGC -> GGTATAGTAAAACCGTGCA
GGCTAGTAACATTTGGTCT -> GCTAGTAACATTTGGTCTC
TTCGATCTCTGGACCACCT -> TCGATCTCTGGACCACCTC
GTGACAAGTGGTTCGGTGA -> TGACAAGTGGTTCGGTGAC
CATCAGTGCTCTGATAGAC -> ATCAGTGCTCTGATAGACG
GATGAGCACTCTATCTCAC -> ATGAGCACTCTATCTCACG
ATGATACTGGAGATGTGAC -> TGATACTGGAGATGTGACA
CGAGAGACCGGGTTTGGGC -> GAGAGACCGGGTTTGGGCA
TCCCCCCGCATTCTACGCG -> CCCCCCGCATTCTACGCGC
GGTGGCGTCACCACAAAGA -> GTGGCGTCACCACAAAGAT
TCTGGACCACCTCAACAAC -> CTGGACCACCTCAACAACA
TATTCACATATTTATTCTT -> ATTCACATATTTATTCTTG
AACAGAAGAGATATATAGG -> ACAGAAGAGATATATAGGC
GATGCCTACCGAAGGTTTA -> ATGCCTACCGAAGGTTTAG
GAGCCGGGTCTGGGATGGC -> AGCCGGGTCTGGGATGGCT
TTCGGCCGTCTAGGCATAG -> TCGGCCGTCTAGGCATAGC
TATTAGTATCTCTAGTCGC -> ATTAGTATCTCTAGTCGCA
CGCGTCGCTGCACGAGTGT -> GCGTCGCTGCACGAGTGTA
CTCTATGGTTCGGTGACCC -> TCTATGGTTCGGTGACCCC
GTGGCCGTTACACCCCGCC -> TGGCCGTTACACCCCGCCC
CCCGAGCATATCCGACATC -> CCGAGCATATCCGACATCG
ATGATACTGGAAAGGGACT -> TGATACTGGAAAGGGACTC
CGTCAGTGCTTACGATGAT -> GTCAGTGCTTACGATGATA
CTGTGACTTTCTAACGAAT -> TGTGACTTTCTAACGAATA
GCAACGAGCACTCGTCTAT -> CAACGAGCACTCGTCTATG
GCAAATTTTTAAACTCCAA -> CAAATTTTTAAACTCCAAG
CTCCAAGTGATATACCAAT -> TCCAAGTGATATACCAATA
GGTGACCCCGACTGCAATG -> GTGACCCCGACTGCAATGG
GACTAAGGTGTAGAAGCAA -> ACTAAGGTGTAGAAGCAAT
TGGTACACATAATGTGCGA -> GGTACACATAATGTGCGAG
GATTTTCGAGAGACCGGGT -> ATTTTCGAGAGACCGGGTT
TCGGTGACCCCGACTTGGC -> CGGTGACCCCGACTTGGCG
TCGGAGCGATCATAGAGAT -> CGGAGCGATCATAGAGATT
TGCCGTTAGGGTTTCTAAC -> GCCGTTAGGGTTTCTAACA
AGCCGGTGGCCGTTACACC -> GCCGGTGGCCGTTACACCC
CTTGGCGTGTAAGTCCAAA -> TTGGCGTGTAAGTCCAAAG
CGGCTACAGCACGCCGCCA -> GGCTACAGCACGCCGCCAC
GACTCAGAGGTGGATCCAT -> ACTCAGAGGTGGATCCATT
GAGCGATCATAGAGATTAC -> AGCGATCATAGAGATTACC
CCTGACTATGTTAACTACG -> CTGACTATGTTAACTACGA
GGTCACACGTAACCCGCTC -> GTCACACGTAACCCGCTCG
ACTGGAAAGGGACTCTATG -> CTGGAAAGGGACTCTATGG
GTGCGAGCCGAAGCAGCTC -> TGCGAGCCGAAGCAGCTCT
AGAAGAGATATATAGGCAC -> GAAGAGATATATAGGCACG
CGCTCCCCCAGTAGGGTCG -> GCTCCCCCAGTAGGGTCGT
ATTCAATGTAATCAGCCCT -> TTCAATGTAATCAGCCCTA
AAATTACCCGAGAGTTAGA -> AATTACCCGAGAGTTAGAT
GATAGACGTGCCCGGCTAC -> ATAGACGTGCCCGGCTACA
TAAGCCATTTAGCTAGTTC -> AAGCCATTTAGCTAGTTCT
TTCGCGTCGCTGCACGAGT -> TCGCGTCGCTGCACGAGTG
TCAGGCTGTGACTTTCTAA -> CAGGCTGTGACTTTCTAAC
TTCGGTGACCCCGACTCTC -> TCGGTGACCCCGACTCTCA
AAGGTTTAGAGATATTCAC -> AGGTTTAGAGATATTCACA
AGATCATAGACTATACTGC -> GATCATAGACTATACTGCT
TGCACCTTATAGCAAATTC -> GCACCTTATAGCAAATTCA
AGCCGCAGATGGTAACTGA -> GCCGCAGATGGTAACTGAT
CTTGAGTATTTTTCGATCT -> TTGAGTATTTTTCGATCTC
GGCTGTGACTTTCTAACGA -> GCTGTGACTTTCTAACGAA
CGTCACCACAAAGATCGCT -> GTCACCACAAAGATCGCTC
GGATTAGAAGCAGCGATTG -> GATTAGAAGCAGCGATTGT
AGCGTAAAGATATTTTTAG -> GCGTAAAGATATTTTTAGT
CTGATAGGCACACTGTGTT -> TGATAGGCACACTGTGTTC
TCTAACACACTGGGTATAG -> CTAACACACTGGGTATAGT
AGCAATGGCTAGTAACATT -> GCAATGGCTAGTAACATTT
CAGACTTCGGCCGTCTAGG -> AGACTTCGGCCGTCTAGGC
AAGCTCGGCGTTTAGCAAT -> AGCTCGGCGTTTAGCAATC
GTATTAGCTGCCCCGAGTC -> TATTAGCTGCCCCGAGTCG
CAGCTAGCCGGTGGCCGTT -> AGCTAGCCGGTGGCCGTTA
CATAGCGACCCCCCACCCG -> ATAGCGACCCCCCACCCGC
AGAGATTACCATTTCGCGT -> GAGATTACCATTTCGCGTC
CTTCAACCGTCTCTTGATG -> TTCAACCGTCTCTTGATGG
AAAGATCGCTCGCACAACT -> AAGATCGCTCGCACAACTC
TCGCATTATTAACAAGTAG -> CGCATTATTAACAAGTAGC
GCTTACGATGATACTGGAT -> CTTACGATGATACTGGATG
CGAGAGTTAGATCATAGAC -> GAGAGTTAGATCATAGACT
CTGCCCCGAGTCGCCCAGG -> TGCCCCGAGTCGCCCAGGC
AGACTAAGGTGTAGAAGCA -> GACTAAGGTGTAGAAGCAA
CTTGGAGGGAGATCCTGAT -> TTGGAGGGAGATCCTGATA
GATCATAGAGATTACCATT -> ATCATAGAGATTACCATTT
GATGATACTGGAAAGGGAC -> ATGATACTGGAAAGGGACT
GGGTGACGGGCCAAGGCTA -> GGTGACGGGCCAAGGCTAT
CAAAGAACAGAAGAGATAT -> AAAGAACAGAAGAGATATA
ATGGAGGGAGTAGACCCCC -> TGGAGGGAGTAGACCCCCC
TCGTCCCGCGTCAAGTATT -> CGTCCCGCGTCAAGTATTG
AGGCCACGCTTACGATGAT -> GGCCACGCTTACGATGATA
AGATAGATTAACCCGAGCA -> GATAGATTAACCCGAGCAT
CGAGCATATCCGACATCGA -> GAGCATATCCGACATCGAG
ACGTGCCCGGCTACAGCAC -> CGTGCCCGGCTACAGCACG
ACTCTATCTCACGATGCAC -> CTCTATCTCACGATGCACC
TAGACGCCGAGATAGATTA -> AGACGCCGAGATAGATTAA
CTCGATCCTAACCATAAGT -> TCGATCCTAACCATAAGTC
ACTATGTTAACTACGATGC -> CTATGTTAACTACGATGCG
ACGACAATTCTCTCCTGAG -> CGACAATTCTCTCCTGAGC
AACAAGTAGCTTGTGCACA -> ACAAGTAGCTTGTGCACAA
ATCGAGACAAGCTAGTAGA -> TCGAGACAAGCTAGTAGAA
TCAGACTTTCGCATGCACC -> CAGACTTTCGCATGCACCT
CCTGAAGCAGACTTCGGCC -> CTGAAGCAGACTTCGGCCG
TAGTTTTATAAGTGTTGGT -> AGTTTTATAAGTGTTGGTA
ACTATTACTCTCAAGCCGC -> CTATTACTCTCAAGCCGCC
ATACTGGATGCACGGACTT -> TACTGGATGCACGGACTTT
CACCCGCCGAAGTACAGTT -> ACCCGCCGAAGTACAGTTA
ACCAATATTTCATCAGTGC -> CCAATATTTCATCAGTGCT
GATTGCCGTTAGGGTTTCT -> ATTGCCGTTAGGGTTTCTA
TCTCAAGCCGCCCTTGAGT -> CTCAAGCCGCCCTTGAGTA
AGCAGCTCTAGCCATCTCA -> GCAGCTCTAGCCATCTCAG
CGTCGCATGTAAGCCATTT -> GTCGCATGTAAGCCATTTA
TTATTAGTATCTCTAGTCG -> TATTAGTATCTCTAGTCGC
GGATTCGCCCGCACGGTCC -> GATTCGCCCGCACGGTCCA
GAGGGAGATCCTGATAGGC -> AGGGAGATCCTGATAGGCA
TCGCTGCACGAGTGTATCG -> CGCTGCACGAGTGTATCGG
CCGAGAGTTAGATCATAGA -> CGAGAGTTAGATCATAGAC
AGCAAATTCAAGGTGACAA -> GCAAATTCAAGGTGACAAG
GATACTGGACCAACCCTGT -> ATACTGGACCAACCCTGTA
TGCCGCTGGTGAACAATAG -> GCCGCTGGTGAACAATAGC
TCTAGGGTCATGTTGGAGA -> CTAGGGTCATGTTGGAGAC
CGCTATGGCCACGGAGTCC -> GCTATGGCCACGGAGTCCT
TACTGGACCAACCCTGTAT -> ACTGGACCAACCCTGTATG
TACGATGATACTGGAGATG -> ACGATGATACTGGAGATGT
ACTATACTGCTGCCACTCT -> CTATACTGCTGCCACTCTT
CGGCTTACCGATTAAGGAG -> GGCTTACCGATTAAGGAGG
CCCAGTAGGGTCGTCAAAA -> CCAGTAGGGTCGTCAAAAC
ACGCTTACGATGATACTGG -> CGCTTACGATGATACTGGA
AAGCATACGATTAATGAGC -> AGCATACGATTAATGAGCC
TCCCCCAGTAGGGTCGTCA -> CCCCCAGTAGGGTCGTCAA
GACATCGAGTAAGTGGTCA -> ACATCGAGTAAGTGGTCAC
TGACCCCGACTTGGCGTGT -> GACCCCGACTTGGCGTGTA
CCGCCCTTGAGTATTTTTC -> CGCCCTTGAGTATTTTTCG
ATATACCAATATTTCATCA -> TATACCAATATTTCATCAG
TCACCTGGCGCTCAAGATA -> CACCTGGCGCTCAAGATAA
CGGGAAATAAAAAAGTGGC -> GGGAAATAAAAAAGTGGCC
CCACCTCAACAACAAGATG -> CACCTCAACAACAAGATGG
TGTAAGCCATTTAGCTAGT -> GTAAGCCATTTAGCTAGTT
AGTAGACCCCCCAGTTTTT -> GTAGACCCCCCAGTTTTTC
CAGGCCACGCTTACGATGA -> AGGCCACGCTTACGATGAT
GTTTTATAAGTGTTGGTAT -> TTTTATAAGTGTTGGTATT
AGTCGTCACGCGGAGCCCT -> GTCGTCACGCGGAGCCCTG
GCGAAGCCGGTGGCGTCAC -> CGAAGCCGGTGGCGTCACC
CCGAGTCGCCCAGGCCACG -> CGAGTCGCCCAGGCCACGC
GTTTCTAACACACTGGGTA -> TTTCTAACACACTGGGTAT
GCCGAAGCGTAAAGATATT -> CCGAAGCGTAAAGATATTT
AAGCTAGTAGAAGGGGGTG -> AGCTAGTAGAAGGGGGTGA
CTGTAAATATCGGCTCTCC -> TGTAAATATCGGCTCTCCG
GGGTCACCTCCTTTTTAAG -> GGTCACCTCCTTTTTAAGC
CTTTCGCATGCACCTTATA -> TTTCGCATGCACCTTATAG
CGGGATTGCCGTTAGGGTT -> GGGATTGCCGTTAGGGTTT
CAAGGCTATATTGCCGCTG -> AAGGCTATATTGCCGCTGG
ATTAAGGAGGTCCTTGCAA -> TTAAGGAGGTCCTTGCAAG
CGCTGCACGAGTGTATCGG -> GCTGCACGAGTGTATCGGT
GTTCTAAATTACCCGAGAG -> TTCTAAATTACCCGAGAGT
CCATTGTGAGGCGAAGCCG -> CATTGTGAGGCGAAGCCGG
CCTCCTTTTTAAGCATACG -> CTCCTTTTTAAGCATACGA
CGCCGTTCTTTATTGTACT -> GCCGTTCTTTATTGTACTA
GTTAGGGTTTCTAACACAC -> TTAGGGTTTCTAACACACT
GTCAAAACTCGCAACAGGA -> TCAAAACTCGCAACAGGAA
TCTATGGTTCGGTGACCCC -> CTATGGTTCGGTGACCCCG
GATAATTGACCTGAAGCAG -> ATAATTGACCTGAAGCAGA
AACCCTGTATGGTTCGGTG -> ACCCTGTATGGTTCGGTGA
CAATACTAGTTAAGCTCGG -> AATACTAGTTAAGCTCGGC
CACAACTCAAAGCCGCAGA -> ACAACTCAAAGCCGCAGAT
ACTTAGCACCTTGTAAGTT -> CTTAGCACCTTGTAAGTTT
ATCCTGATAGGCACACTGT -> TCCTGATAGGCACACTGTG
ACCCCGCCCGACGATCGCT -> CCCCGCCCGACGATCGCTG
GTATTGACCTGATGAGCAC -> TATTGACCTGATGAGCACT
ATAGTAAAACCGTGCATAT -> TAGTAAAACCGTGCATATT
CTGGATCACGTGGTCGTCC -> TGGATCACGTGGTCGTCCC
TAAGTCCAAAGCTGATATG -> AAGTCCAAAGCTGATATGG
TGATACTGGATGCACGGAC -> GATACTGGATGCACGGACT
TCATGTTGGAGACTTCAAC -> CATGTTGGAGACTTCAACC
CGAAGCGGTCACACGTAAC -> GAAGCGGTCACACGTAACC
ACGGTTCTCGATCCTAACC -> CGGTTCTCGATCCTAACCA
GCCGAGATAGATTAACCCG -> CCGAGATAGATTAACCCGA
ATACTGGAAAGGGACTCTA -> TACTGGAAAGGGACTCTAT
AAGTATAACGGAAATTCAA -> AGTATAACGGAAATTCAAT
TGATGAGCACTCTATCTCA -> GATGAGCACTCTATCTCAC
AGTAATTTCACTTAGCACC -> GTAATTTCACTTAGCACCT
TCAAGATAATTGACCTGAA -> CAAGATAATTGACCTGAAG
CAACTCAAAGCCGCAGATG -> AACTCAAAGCCGCAGATGG
AGTAAAACCGTGCATATTC -> GTAAAACCGTGCATATTCA
AGTGCCGCAGACTACATCG -> GTGCCGCAGACTACATCGA
TGACAAGTATAACGGAAAT -> GACAAGTATAACGGAAATT
GGAGCCCTGCGGTTGATTT -> GAGCCCTGCGGTTGATTTA
GTCAGTGCTTACGATGATA -> TCAGTGCTTACGATGATAC
GTGGTCGTCCCGCGTCAAG -> TGGTCGTCCCGCGTCAAGT
TTGGCGTGTAAGTCCAAAG -> TGGCGTGTAAGTCCAAAGC
GACCTGATGAGCACTCTAT -> ACCTGATGAGCACTCTATC
TGAGCCTGCGGCTTACCGA -> GAGCCTGCGGCTTACCGAT
CGACCCCCCACCCGCCGAA -> GACCCCCCACCCGCCGAAG
TTTAAGCAAATTTTTAAAC -> TTAAGCAAATTTTTAAACT
ACCCCGACTGCAATGGTGC -> CCCCGACTGCAATGGTGCG
TAAATATCGGCTCTCCGGG -> AAATATCGGCTCTCCGGGA
CTCTAGTCGCATTATTAAC -> TCTAGTCGCATTATTAACA
TAAAACCGTGCATATTCAG -> AAAACCGTGCATATTCAGA
ATTGACCTGATGAGCACTC -> TTGACCTGATGAGCACTCT
TGCCGCAGACTACATCGAG -> GCCGCAGACTACATCGAGA
GCGTCAAGTATTGGTCTAG -> CGTCAAGTATTGGTCTAGT
ATAGGCACACTGTGTTCGA -> TAGGCACACTGTGTTCGAT
ATACTGCTGCCACTCTTTA -> TACTGCTGCCACTCTTTAA
CGTTACACCCCGCCCGACG -> GTTACACCCCGCCCGACGA
ACATACGGGTCTCGGCTTA -> CATACGGGTCTCGGCTTAC
TCGATCCTAACCATAAGTC -> CGATCCTAACCATAAGTCG
GGACTCTATGGTTCGGTGA -> GACTCTATGGTTCGGTGAC
CCGAGATAGATTAACCCGA -> CGAGATAGATTAACCCGAG
CATAAGTCGTCACGCGGAG -> ATAAGTCGTCACGCGGAGC
TTCGCCCGCACGGTCCAGA -> TCGCCCGCACGGTCCAGAA
TAATGAGCCTGCGGCTTAC -> AATGAGCCTGCGGCTTACC
AATTCTCTCCTGAGCCGGG -> ATTCTCTCCTGAGCCGGGT
CTGCCTCGCCCGTTCCCTT -> TGCCTCGCCCGTTCCCTTT
CTGCGACATACGGGTCTCG -> TGCGACATACGGGTCTCGG
TTCGCATGCACCTTATAGC -> TCGCATGCACCTTATAGCA
TCGGTGACCCCGACTCAGA -> CGGTGACCCCGACTCAGAG
ATTTTTCGATCTCTGGACC -> TTTTTCGATCTCTGGACCA
ATATCCGACATCGAGTAAG -> TATCCGACATCGAGTAAGT
GGAAAGGGACTCTATGGTT -> GAAAGGGACTCTATGGTTC
GTAAGTTTAGCTTACGATG -> TAAGTTTAGCTTACGATGA
AGGCTATATTGCCGCTGGT -> GGCTATATTGCCGCTGGTG
GACGTGCCCGGCTACAGCA -> ACGTGCCCGGCTACAGCAC
CCACGGAGTCCTATTCTAT -> CACGGAGTCCTATTCTATT
GCATGCACCTTATAGCAAA -> CATGCACCTTATAGCAAAT
CAACCCTGTATGGTTCGGT -> AACCCTGTATGGTTCGGTG
TCGGCTCTCCGGGATTAGA -> CGGCTCTCCGGGATTAGAA
GTAAGCCATTTAGCTAGTT -> TAAGCCATTTAGCTAGTTC
TGGTGCGTTCCGATTGTGG -> GGTGCGTTCCGATTGTGGT
GAACAGAAGAGATATATAG -> AACAGAAGAGATATATAGG
GTTGGTATTGACCTGATGA -> TTGGTATTGACCTGATGAG
AATCCTCGTAGCCGAAGCG -> ATCCTCGTAGCCGAAGCGT
GAGATCCTGATAGGCACAC -> AGATCCTGATAGGCACACT
GGCTTACCGATTAAGGAGG -> GCTTACCGATTAAGGAGGT
AGAGATATATAGGCACGCG -> GAGATATATAGGCACGCGC
TTTGGTTCGGTGACCCCGA -> TTGGTTCGGTGACCCCGAC
TTCCTGACTATGTTAACTA -> TCCTGACTATGTTAACTAC
GCTCGCACAACTCAAAGCC -> CTCGCACAACTCAAAGCCG
ACTACATCGAGACAAGCTA -> CTACATCGAGACAAGCTAG
TACGGGTCTCGGCTTACGA -> ACGGGTCTCGGCTTACGAT
TTAGAGATATTCACATATT -> TAGAGATATTCACATATTT
CCCCACAGAAGTACGGTTC -> CCCACAGAAGTACGGTTCT
TTTCCGGGAAATAAAAAAG -> TTCCGGGAAATAAAAAAGT
TTTCGAGAGACCGGGTTTG -> TTCGAGAGACCGGGTTTGG
TACAGTTATGTCGGTAGAC -> ACAGTTATGTCGGTAGACT
GCGGAGCCCTGCGGTTGAT -> CGGAGCCCTGCGGTTGATT
TCCTTGAATGTGCTGGATC -> CCTTGAATGTGCTGGATCA
TGTGTTCGATCACATCAAA -> GTGTTCGATCACATCAAAC
GGTCAGCTAGCCGGTGGCC -> GTCAGCTAGCCGGTGGCCG
TGCACAAAGAACAGAAGAG -> GCACAAAGAACAGAAGAGA
ACCCCGGCCCCCTGTATCT -> CCCCGGCCCCCTGTATCTG
TTGGGCAAGTAATTTCACT -> TGGGCAAGTAATTTCACTT
GATCACATCAAACGCTATG -> ATCACATCAAACGCTATGG
ATATTCACATATTTATTCT -> TATTCACATATTTATTCTT
CGGCCCCCTGTATCTGCCT -> GGCCCCCTGTATCTGCCTC
TATATAGGCACGCGCGCTC -> ATATAGGCACGCGCGCTCT
AGCGTCGCATGTAAGCCAT -> GCGTCGCATGTAAGCCATT
ATCGCTGCCGTATTAGCTG -> TCGCTGCCGTATTAGCTGC
AATAGACATGGGGTCACCT -> ATAGACATGGGGTCACCTC
ATTCACATATTTATTCTTG -> TTCACATATTTATTCTTGG
CAAGTAGCTTGTGCACAAA -> AAGTAGCTTGTGCACAAAG
ATGGTTCGGTGACCCCGAC -> TGGTTCGGTGACCCCGACT,TGGTTCGGTGACCCCGACT
TCAAAACTCGCAACAGGAA -> CAAAACTCGCAACAGGAAG
AGATGGATTCGCCCGCACG -> GATGGATTCGCCCGCACGG
GAAGTACAGTTATGTCGGT -> AAGTACAGTTATGTCGGTA
AATGGTGCGTTCCGATTGT -> ATGGTGCGTTCCGATTGTG
AGGCTGTGACTTTCTAACG -> GGCTGTGACTTTCTAACGA
TCTAGTCGCATTATTAACA -> CTAGTCGCATTATTAACAA
GCTGCACGAGTGTATCGGT -> CTGCACGAGTGTATCGGTT
TGGACGGAACGAGTAAAAT -> GGACGGAACGAGTAAAATA
GGCGTGTAAGTCCAAAGCT -> GCGTGTAAGTCCAAAGCTG
GCCGCAGATGGTAACTGAT -> CCGCAGATGGTAACTGATT
AGTAAGTGGTCACCTGGCG -> GTAAGTGGTCACCTGGCGC
CTTACGATGATACTGGAAA -> TTACGATGATACTGGAAAG
GGTGCGTTCCGATTGTGGT -> GTGCGTTCCGATTGTGGTC
AGGTGACAAGTATAACGGA -> GGTGACAAGTATAACGGAA
AGTATAACGGAAATTCAAT -> GTATAACGGAAATTCAATG
CACCCCACAGAAGTACGGT -> ACCCCACAGAAGTACGGTT
GCACGGTCCAGAACGTTAC -> CACGGTCCAGAACGTTACG
ACCATAAGTCGTCACGCGG -> CCATAAGTCGTCACGCGGA
CAGAACGTTACGGTGTCCT -> AGAACGTTACGGTGTCCTC
GGCCACGCTTACGATGATA -> GCCACGCTTACGATGATAC
AGAAGCAGCGATTGTACAA -> GAAGCAGCGATTGTACAAC
GGCAAGTAATTTCACTTAG -> GCAAGTAATTTCACTTAGC
AGTAGCTTGTGCACAAAGA -> GTAGCTTGTGCACAAAGAA
GCCGTTACACCCCGCCCGA -> CCGTTACACCCCGCCCGAC
GGGATTGCCGTTAGGGTTT -> GGATTGCCGTTAGGGTTTC
GTTCGGTGACCCCGACTCT -> TTCGGTGACCCCGACTCTC
ACCCGAGCATATCCGACAT -> CCCGAGCATATCCGACATC
TTCACATATTTATTCTTGG -> TCACATATTTATTCTTGGA
CTATTGGTACACATAATGT -> TATTGGTACACATAATGTG
GCTTACCGATTAAGGAGGT -> CTTACCGATTAAGGAGGTC
CTGCCGTATTAGCTGCCCC -> TGCCGTATTAGCTGCCCCG
AATTACCCGAGAGTTAGAT -> ATTACCCGAGAGTTAGATC
AAGCCGCAGATGGTAACTG -> AGCCGCAGATGGTAACTGA
CTCGCACAACTCAAAGCCG -> TCGCACAACTCAAAGCCGC
GAGGCGAAGCCGGTGGCGT -> AGGCGAAGCCGGTGGCGTC
TTCCTTGAATGTGCTGGAT -> TCCTTGAATGTGCTGGATC
CAAGTAGAGGTAAGTGACA -> AAGTAGAGGTAAGTGACAT
TGGGTATAGTAAAACCGTG -> GGGTATAGTAAAACCGTGC
TCGATCTCTGGACCACCTC -> CGATCTCTGGACCACCTCA
AGCCGCCCTTGAGTATTTT -> GCCGCCCTTGAGTATTTTT
CGCATGTAAGCCATTTAGC -> GCATGTAAGCCATTTAGCT
CCCAGTTTTTCCAGATGCC -> CCAGTTTTTCCAGATGCCT
ATGCACCCCACAGAAGTAC -> TGCACCCCACAGAAGTACG
TCACCACAAAGATCGCTCG -> CACCACAAAGATCGCTCGC
AAGTACGGTTCTCGATCCT -> AGTACGGTTCTCGATCCTA
TCGAGAGACCGGGTTTGGG -> CGAGAGACCGGGTTTGGGC
ACCTGATGAGCACTCTATC -> CCTGATGAGCACTCTATCT
GGTTTGGGCAAGTAATTTC -> GTTTGGGCAAGTAATTTCA
TCATAGACTATACTGCTGC -> CATAGACTATACTGCTGCC
GCTCTGATAGACGTGCCCG -> CTCTGATAGACGTGCCCGG
GTCACGCGGAGCCCTGCGG -> TCACGCGGAGCCCTGCGGT
GTGTATCGGTTCGTCGATT -> TGTATCGGTTCGTCGATTT
AATTTCACTTAGCACCTTG -> ATTTCACTTAGCACCTTGT
CAGACTTTCGCATGCACCT -> AGACTTTCGCATGCACCTT
CGTCTAGGCATAGCGACCC -> GTCTAGGCATAGCGACCCC
TGGAGATGTGACAAGTGGT -> GGAGATGTGACAAGTGGTT
TGAGTATTTTTCGATCTCT -> GAGTATTTTTCGATCTCTG
GCAATGGTGCGTTCCGATT -> CAATGGTGCGTTCCGATTG
TTCAAGGTGACAAGTATAA -> TCAAGGTGACAAGTATAAC
CAAAGATCGCTCGCACAAC -> AAAGATCGCTCGCACAACT
GCACAACTCAAAGCCGCAG -> CACAACTCAAAGCCGCAGA
TGACCCCGGCCCCCTGTAT -> GACCCCGGCCCCCTGTATC
GGTATTGACCTGATGAGCA -> GTATTGACCTGATGAGCAC
TGGTCTAGTGGCGCCGTTC -> GGTCTAGTGGCGCCGTTCT
GGCGGTCCAGTGCCGCAGA -> GCGGTCCAGTGCCGCAGAC
TTTTATAAGTGTTGGTATT -> TTTATAAGTGTTGGTATTG
AAGGGACTCTATGGTTCGG -> AGGGACTCTATGGTTCGGT
ATTACTCTCAAGCCGCCCT -> TTACTCTCAAGCCGCCCTT
GACAAGCTAGTAGAAGGGG -> ACAAGCTAGTAGAAGGGGG
CGAGACAAGCTAGTAGAAG -> GAGACAAGCTAGTAGAAGG
TCTGTAAATATCGGCTCTC -> CTGTAAATATCGGCTCTCC
AACTACGATGCGGGATTGC -> ACTACGATGCGGGATTGCC
GTCCTCCCCCCGCATTCTA -> TCCTCCCCCCGCATTCTAC
TTAGGGTTTCTAACACACT -> TAGGGTTTCTAACACACTG
CAAGCCGCCCTTGAGTATT -> AAGCCGCCCTTGAGTATTT
CGTTTAGCAATCCTCGTAG -> GTTTAGCAATCCTCGTAGC
TTCGAGAGACCGGGTTTGG -> TCGAGAGACCGGGTTTGGG
ATTGGTCTAGTGGCGCCGT -> TTGGTCTAGTGGCGCCGTT
ATTAGCTGCCCCGAGTCGC -> TTAGCTGCCCCGAGTCGCC
AACGTTACGGTGTCCTCCC -> ACGTTACGGTGTCCTCCCC
CTAGCGTCAGTGCTTACGA -> TAGCGTCAGTGCTTACGAT
ACACACTGGGTATAGTAAA -> CACACTGGGTATAGTAAAA
TAATTGACCTGAAGCAGAC -> AATTGACCTGAAGCAGACT
AGTGGCCCAGCGTGGACGG -> GTGGCCCAGCGTGGACGGA
CCACTCTTTAAGCAAATTT -> CACTCTTTAAGCAAATTTT
CGCTGCCGTATTAGCTGCC -> GCTGCCGTATTAGCTGCCC
GGGATGGCTTCCTGACTAT -> GGATGGCTTCCTGACTATG
TCCTATTCTATTGGTACAC -> CCTATTCTATTGGTACACA
GCCTACCGAAGGTTTAGAG -> CCTACCGAAGGTTTAGAGA
CTCTCTAATAGACATGGGG -> TCTCTAATAGACATGGGGT
CTAATAGACATGGGGTCAC -> TAATAGACATGGGGTCACC
CCCCCCACCCGCCGAAGTA -> CCCCCACCCGCCGAAGTAC
TATGTCGGTAGACTAAGGT -> ATGTCGGTAGACTAAGGTG
TATTGGTCTAGTGGCGCCG -> ATTGGTCTAGTGGCGCCGT
TCGCCCGCACGGTCCAGAA -> CGCCCGCACGGTCCAGAAC
TGGCCGTTACACCCCGCCC -> GGCCGTTACACCCCGCCCG
GTCAGCTAGCCGGTGGCCG -> TCAGCTAGCCGGTGGCCGT
TTAGATCATAGACTATACT -> TAGATCATAGACTATACTG
GTCGGTAGACTAAGGTGTA -> TCGGTAGACTAAGGTGTAG
GCTCTAGCCATCTCAGGCT -> CTCTAGCCATCTCAGGCTG
AACAACAAGATGGATTCGC -> ACAACAAGATGGATTCGCC
GGCCGTTACACCCCGCCCG -> GCCGTTACACCCCGCCCGA
GTTCCCTTTCCTTGAATGT -> TTCCCTTTCCTTGAATGTG
TTAGAAGCAGCGATTGTAC -> TAGAAGCAGCGATTGTACA
AGGGTTTCTAACACACTGG -> GGGTTTCTAACACACTGGG
CCCCCTGTATCTGCCTCGC -> CCCCTGTATCTGCCTCGCC
CTCGTCTATGTTTATTAGT -> TCGTCTATGTTTATTAGTA
TGTTAACTACGATGCGGGA -> GTTAACTACGATGCGGGAT
TAAGTGGTCACCTGGCGCT -> AAGTGGTCACCTGGCGCTC
CGGACTTTGGTTCGGTGAC -> GGACTTTGGTTCGGTGACC
ACCACAAAGATCGCTCGCA -> CCACAAAGATCGCTCGCAC
AGCACGCCGCCACGACAAT -> GCACGCCGCCACGACAATT
CAATGGTGCGTTCCGATTG -> AATGGTGCGTTCCGATTGT
AGCACTCTATCTCACGATG -> GCACTCTATCTCACGATGC
GCCACGGAGTCCTATTCTA -> CCACGGAGTCCTATTCTAT
GGAGGGAGATCCTGATAGG -> GAGGGAGATCCTGATAGGC
AGAACGTTACGGTGTCCTC -> GAACGTTACGGTGTCCTCC
GCGCGCTCTCTAATAGACA -> CGCGCTCTCTAATAGACAT
AGGAAGTTCTAGGGTCATG -> GGAAGTTCTAGGGTCATGT
CAAGTATAACGGAAATTCA -> AAGTATAACGGAAATTCAA
TCGAGACAAGCTAGTAGAA -> CGAGACAAGCTAGTAGAAG
GTGTCCTCCCCCCGCATTC -> TGTCCTCCCCCCGCATTCT
GACTATACTGCTGCCACTC -> ACTATACTGCTGCCACTCT
CTAGTTAAGCTCGGCGTTT -> TAGTTAAGCTCGGCGTTTA
TGCTGCCACTCTTTAAGCA -> GCTGCCACTCTTTAAGCAA
GGTGACCCCGACTCAGAGG -> GTGACCCCGACTCAGAGGT
AAAACTCGCAACAGGAAGT -> AAACTCGCAACAGGAAGTT
TTGGTATTGACCTGATGAG -> TGGTATTGACCTGATGAGC
TAACAAGTAGCTTGTGCAC -> AACAAGTAGCTTGTGCACA
TAGGCACGCGCGCTCTCTA -> AGGCACGCGCGCTCTCTAA
AAATAAAAAAGTGGCCCAG -> AATAAAAAAGTGGCCCAGC
GGATCACGTGGTCGTCCCG -> GATCACGTGGTCGTCCCGC
AGCCCTGCGGTTGATTTAT -> GCCCTGCGGTTGATTTATC
AGCTAGTTCTAAATTACCC -> GCTAGTTCTAAATTACCCG
ACACTGTGTTCGATCACAT -> CACTGTGTTCGATCACATC
GGTTGATTTATCTAGCGTC -> GTTGATTTATCTAGCGTCA
AGCGTCAGTGCTTACGATG -> GCGTCAGTGCTTACGATGA
TGGTCAGCTAGCCGGTGGC -> GGTCAGCTAGCCGGTGGCC
TGGAGGGAGATCCTGATAG -> GGAGGGAGATCCTGATAGG
TACTGGAAAGGGACTCTAT -> ACTGGAAAGGGACTCTATG
CTCTAGCCATCTCAGGCTG -> TCTAGCCATCTCAGGCTGT
CTCTGATAGACGTGCCCGG -> TCTGATAGACGTGCCCGGC
TACGATGATACTGGATGCA -> ACGATGATACTGGATGCAC
AACAATAGCCTGCGACATA -> ACAATAGCCTGCGACATAC
AATGTGCGAGCCGAAGCAG -> ATGTGCGAGCCGAAGCAGC
GCCACGACAATTCTCTCCT -> CCACGACAATTCTCTCCTG
GTCGTCACGCGGAGCCCTG -> TCGTCACGCGGAGCCCTGC
TACAACGAGTAGCGTCGCA -> ACAACGAGTAGCGTCGCAT
ACGCGCGCTCTCTAATAGA -> CGCGCGCTCTCTAATAGAC
GTCCTTGCAAGTAGAGGTA -> TCCTTGCAAGTAGAGGTAA
AGTTCTAAATTACCCGAGA -> GTTCTAAATTACCCGAGAG
TCTGGGATGGCTTCCTGAC -> CTGGGATGGCTTCCTGACT
CGGCTCTCCGGGATTAGAA -> GGCTCTCCGGGATTAGAAG
GTCCTATTCTATTGGTACA -> TCCTATTCTATTGGTACAC
GTCGCTGCACGAGTGTATC -> TCGCTGCACGAGTGTATCG
ACGGAAATTCAATGTAATC -> CGGAAATTCAATGTAATCA
GTCACACGTAACCCGCTCG -> TCACACGTAACCCGCTCGG
CCCCAGTAGGGTCGTCAAA -> CCCAGTAGGGTCGTCAAAA
ATGGATTCGCCCGCACGGT -> TGGATTCGCCCGCACGGTC
TAACGAATACAATACTAGT -> AACGAATACAATACTAGTT
CCTCCCCCCGCATTCTACG -> CTCCCCCCGCATTCTACGC
CCTCAACAACAAGATGGAT -> CTCAACAACAAGATGGATT
CAATGTAATCAGCCCTAGT -> AATGTAATCAGCCCTAGTG
TTGATGGAGGGAGTAGACC -> TGATGGAGGGAGTAGACCC
TCTAACGAATACAATACTA -> CTAACGAATACAATACTAG
TCTCTTTCCGGGAAATAAA -> CTCTTTCCGGGAAATAAAA
AACGAATACAATACTAGTT -> ACGAATACAATACTAGTTA
TACCAATATTTCATCAGTG -> ACCAATATTTCATCAGTGC
CGATTAAGGAGGTCCTTGC -> GATTAAGGAGGTCCTTGCA
TTAGCACCTTGTAAGTTTA -> TAGCACCTTGTAAGTTTAG
CCTTGAATGTGCTGGATCA -> CTTGAATGTGCTGGATCAC
AGGTGTAGAAGCAATGGCT -> GGTGTAGAAGCAATGGCTA
AGGGGGTGACGGGCCAAGG -> GGGGGTGACGGGCCAAGGC
TATAGTAAAACCGTGCATA -> ATAGTAAAACCGTGCATAT
TGGTCGTCCCGCGTCAAGT -> GGTCGTCCCGCGTCAAGTA
GCTCGGCGTTTAGCAATCC -> CTCGGCGTTTAGCAATCCT
TGGATCACGTGGTCGTCCC -> GGATCACGTGGTCGTCCCG
TTTCTAACACACTGGGTAT -> TTCTAACACACTGGGTATA
CGTTCCCTTTCCTTGAATG -> GTTCCCTTTCCTTGAATGT
GTCTCTTTCCGGGAAATAA -> TCTCTTTCCGGGAAATAAA
TTCGGTGACCCCGACTTGG -> TCGGTGACCCCGACTTGGC
CACATAATGTGCGAGCCGA -> ACATAATGTGCGAGCCGAA
GATGCGGGATTGCCGTTAG -> ATGCGGGATTGCCGTTAGG
TCCATTGTGAGGCGAAGCC -> CCATTGTGAGGCGAAGCCG
GTAAAGATATTTTTAGTTT -> TAAAGATATTTTTAGTTTT
ACTCTATGGTTCGGTGACC -> CTCTATGGTTCGGTGACCC
ATACTGGAGATGTGACAAG -> TACTGGAGATGTGACAAGT
TTTCGCATGCACCTTATAG -> TTCGCATGCACCTTATAGC
AGATCCTGATAGGCACACT -> GATCCTGATAGGCACACTG
CTTTGGTTCGGTGACCCCG -> TTTGGTTCGGTGACCCCGA
CGATTTTCGAGAGACCGGG -> GATTTTCGAGAGACCGGGT
TTCGTCGATTTTCGAGAGA -> TCGTCGATTTTCGAGAGAC
AACAAGATGGATTCGCCCG -> ACAAGATGGATTCGCCCGC
CGACATACGGGTCTCGGCT -> GACATACGGGTCTCGGCTT
GTAGAAGCAATGGCTAGTA -> TAGAAGCAATGGCTAGTAA
AACCGTCTCTTGATGGAGG -> ACCGTCTCTTGATGGAGGG
TTTGGGCAAGTAATTTCAC -> TTGGGCAAGTAATTTCACT
GACCCCGACTTGGCGTGTA -> ACCCCGACTTGGCGTGTAA
GAGCCTGCGGCTTACCGAT -> AGCCTGCGGCTTACCGATT
AAACTCCAAGTGATATACC -> AACTCCAAGTGATATACCA
AGGGACTCTATGGTTCGGT -> GGGACTCTATGGTTCGGTG
ATGTGCTGGATCACGTGGT -> TGTGCTGGATCACGTGGTC
ATGTCGGTAGACTAAGGTG -> TGTCGGTAGACTAAGGTGT
CTCTAATAGACATGGGGTC -> TCTAATAGACATGGGGTCA
TAAGCAAATTTTTAAACTC -> AAGCAAATTTTTAAACTCC
GTAGACCCCCCAGTTTTTC -> TAGACCCCCCAGTTTTTCC
ACGGGTCTCGGCTTACGAT -> CGGGTCTCGGCTTACGATG
TTCTAGGGTCATGTTGGAG -> TCTAGGGTCATGTTGGAGA
CTCGGAGCGATCATAGAGA -> TCGGAGCGATCATAGAGAT
ACGATGATACTGGAAAGGG -> CGATGATACTGGAAAGGGA
CAAGTAATTTCACTTAGCA -> AAGTAATTTCACTTAGCAC
CACAAAGAACAGAAGAGAT -> ACAAAGAACAGAAGAGATA
ACTCTCAAGCCGCCCTTGA -> CTCTCAAGCCGCCCTTGAG
CGCACAACTCAAAGCCGCA -> GCACAACTCAAAGCCGCAG
CATGTTGGAGACTTCAACC -> ATGTTGGAGACTTCAACCG
GAGATTACCATTTCGCGTC -> AGATTACCATTTCGCGTCG
CACCTCAACAACAAGATGG -> ACCTCAACAACAAGATGGA
TATTGTACTAAACAACGAA -> ATTGTACTAAACAACGAAA
CCCCCCGCATTCTACGCGC -> CCCCCGCATTCTACGCGCT
TCTACGCGCTCCCCCAGTA -> CTACGCGCTCCCCCAGTAG
ACGATGATACTGGAGATGT -> CGATGATACTGGAGATGTG
CACGTAACCCGCTCGGAGC -> ACGTAACCCGCTCGGAGCG
GGCGTTTAGCAATCCTCGT -> GCGTTTAGCAATCCTCGTA
TCCTCGTAGCCGAAGCGTA -> CCTCGTAGCCGAAGCGTAA
TGCACGGACTTTGGTTCGG -> GCACGGACTTTGGTTCGGT
CATTTAGCTAGTTCTAAAT -> ATTTAGCTAGTTCTAAATT
GGATCCATTGTGAGGCGAA -> GATCCATTGTGAGGCGAAG
GAGTTAGATCATAGACTAT -> AGTTAGATCATAGACTATA
AGTACGGTTCTCGATCCTA -> GTACGGTTCTCGATCCTAA
AAAGATATTTTTAGTTTTA -> AAGATATTTTTAGTTTTAT
AAATACGATACTGACCCCG -> AATACGATACTGACCCCGG
TAGTGTCTGTAAATATCGG -> AGTGTCTGTAAATATCGGC
AGTTCTAGGGTCATGTTGG -> GTTCTAGGGTCATGTTGGA
TTATCTAGCGTCAGTGCTT -> TATCTAGCGTCAGTGCTTA
ATTGCCGCTGGTGAACAAT -> TTGCCGCTGGTGAACAATA
CTAACCATAAGTCGTCACG -> TAACCATAAGTCGTCACGC
GTAGCCGAAGCGTAAAGAT -> TAGCCGAAGCGTAAAGATA
GTATTGGTCTAGTGGCGCC -> TATTGGTCTAGTGGCGCCG
TTCAACCGTCTCTTGATGG -> TCAACCGTCTCTTGATGGA
CTTACGATGATACTGGATG -> TTACGATGATACTGGATGC
AAAACCGTGCATATTCAGA -> AAACCGTGCATATTCAGAA
CGTTACGGTGTCCTCCCCC -> GTTACGGTGTCCTCCCCCC
CAAGCTAGTAGAAGGGGGT -> AAGCTAGTAGAAGGGGGTG
ATAGCCTGCGACATACGGG -> TAGCCTGCGACATACGGGT
ATGAGCCTGCGGCTTACCG -> TGAGCCTGCGGCTTACCGA
AGTGGTTCGGTGACCCCGA -> GTGGTTCGGTGACCCCGAC
AGCTGCCCCGAGTCGCCCA -> GCTGCCCCGAGTCGCCCAG
TACGATACTGACCCCGGCC -> ACGATACTGACCCCGGCCC
GCGTAAAGATATTTTTAGT -> CGTAAAGATATTTTTAGTT
TGACCCCGACTCAGAGGTG -> GACCCCGACTCAGAGGTGG
GTTCTAGGGTCATGTTGGA -> TTCTAGGGTCATGTTGGAG
TAACACACTGGGTATAGTA -> AACACACTGGGTATAGTAA
TAGAGATTACCATTTCGCG -> AGAGATTACCATTTCGCGT
CGATGATACTGGAGATGTG -> GATGATACTGGAGATGTGA
ATAGACGCCGAGATAGATT -> TAGACGCCGAGATAGATTA
CCGGCCCCCTGTATCTGCC -> CGGCCCCCTGTATCTGCCT
AGCCGAAGCGTAAAGATAT -> GCCGAAGCGTAAAGATATT
TTTATTGTACTAAACAACG -> TTATTGTACTAAACAACGA
GCCGCCCTTGAGTATTTTT -> CCGCCCTTGAGTATTTTTC
AATGTGCTGGATCACGTGG -> ATGTGCTGGATCACGTGGT
TCGCATGCACCTTATAGCA -> CGCATGCACCTTATAGCAA
TTGCCGTTAGGGTTTCTAA -> TGCCGTTAGGGTTTCTAAC
CTACGATGCGGGATTGCCG -> TACGATGCGGGATTGCCGT
CATGTAAGCCATTTAGCTA -> ATGTAAGCCATTTAGCTAG
TGGATGCACGGACTTTGGT -> GGATGCACGGACTTTGGTT
TAAAATACGATACTGACCC -> AAAATACGATACTGACCCC
TTCCCTTTCCTTGAATGTG -> TCCCTTTCCTTGAATGTGC
ATACGGGTCTCGGCTTACG -> TACGGGTCTCGGCTTACGA
TGTGCACAAAGAACAGAAG -> GTGCACAAAGAACAGAAGA
TAGCCTGCGACATACGGGT -> AGCCTGCGACATACGGGTC
GACTTTCGCATGCACCTTA -> ACTTTCGCATGCACCTTAT
TCGATCACATCAAACGCTA -> CGATCACATCAAACGCTAT
GTGTTCGATCACATCAAAC -> TGTTCGATCACATCAAACG
GCATAGCGACCCCCCACCC -> CATAGCGACCCCCCACCCG
GTTGATTTATCTAGCGTCA -> TTGATTTATCTAGCGTCAG
CGGCTTACGATGATACTGG -> GGCTTACGATGATACTGGA
AAGCAATGGCTAGTAACAT -> AGCAATGGCTAGTAACATT
CTACATCGAGACAAGCTAG -> TACATCGAGACAAGCTAGT
GAGTAAGTGGTCACCTGGC -> AGTAAGTGGTCACCTGGCG
GGGGGTGACGGGCCAAGGC -> GGGGTGACGGGCCAAGGCT
CTCTCAGACTTTCGCATGC -> TCTCAGACTTTCGCATGCA
ACCGTCTCTTGATGGAGGG -> CCGTCTCTTGATGGAGGGA
AAGCAAATTTTTAAACTCC -> AGCAAATTTTTAAACTCCA
CCCTGTATGGTTCGGTGAC -> CCTGTATGGTTCGGTGACC
TAAGCTCGGCGTTTAGCAA -> AAGCTCGGCGTTTAGCAAT
CAACAACAAGATGGATTCG -> AACAACAAGATGGATTCGC
CCTCGTAGCCGAAGCGTAA -> CTCGTAGCCGAAGCGTAAA
TCTCTAGTCGCATTATTAA -> CTCTAGTCGCATTATTAAC
GAATACAATACTAGTTAAG -> AATACAATACTAGTTAAGC
TAGCGACCCCCCACCCGCC -> AGCGACCCCCCACCCGCCG
CAGGCTGTGACTTTCTAAC -> AGGCTGTGACTTTCTAACG
GTCTAGGCATAGCGACCCC -> TCTAGGCATAGCGACCCCC
GATTAAGGAGGTCCTTGCA -> ATTAAGGAGGTCCTTGCAA
GTGGTCACCTGGCGCTCAA -> TGGTCACCTGGCGCTCAAG
ACTGACCCCGGCCCCCTGT -> CTGACCCCGGCCCCCTGTA
GCTTACGATGATACTGGAC -> CTTACGATGATACTGGACC
GAAGGTTTAGAGATATTCA -> AAGGTTTAGAGATATTCAC
GTGCATATTCAGAATAAGC -> TGCATATTCAGAATAAGCG
CCCAGGCCACGCTTACGAT -> CCAGGCCACGCTTACGATG
AGGCATAGCGACCCCCCAC -> GGCATAGCGACCCCCCACC
AGTATTTTTCGATCTCTGG -> GTATTTTTCGATCTCTGGA
CCCCGGCCCCCTGTATCTG -> CCCGGCCCCCTGTATCTGC
TTAAGCTCGGCGTTTAGCA -> TAAGCTCGGCGTTTAGCAA
CACACGTAACCCGCTCGGA -> ACACGTAACCCGCTCGGAG
GTAGACTAAGGTGTAGAAG -> TAGACTAAGGTGTAGAAGC
CATACGATTAATGAGCCTG -> ATACGATTAATGAGCCTGC
CTATGTTTATTAGTATCTC -> TATGTTTATTAGTATCTCT
CGTTAGGGTTTCTAACACA -> GTTAGGGTTTCTAACACAC
TCTTTAAGCAAATTTTTAA -> CTTTAAGCAAATTTTTAAA
AATATCGGCTCTCCGGGAT -> ATATCGGCTCTCCGGGATT
GGTCACCTGGCGCTCAAGA -> GTCACCTGGCGCTCAAGAT
CCCGCGTCAAGTATTGGTC -> CCGCGTCAAGTATTGGTCT
GTGCTGGATCACGTGGTCG -> TGCTGGATCACGTGGTCGT
ACATCGAGTAAGTGGTCAC -> CATCGAGTAAGTGGTCACC
TACTGGATGCACGGACTTT -> ACTGGATGCACGGACTTTG
AGTTAGATCATAGACTATA -> GTTAGATCATAGACTATAC
AATGTAATCAGCCCTAGTG -> ATGTAATCAGCCCTAGTGT
CCATTTCGCGTCGCTGCAC -> CATTTCGCGTCGCTGCACG
AGAAGCAATGGCTAGTAAC -> GAAGCAATGGCTAGTAACA
TTTTCCAGATGCCTACCGA -> TTTCCAGATGCCTACCGAA
GAAATAAAAAAGTGGCCCA -> AAATAAAAAAGTGGCCCAG
CCGCACGGTCCAGAACGTT -> CGCACGGTCCAGAACGTTA
GGGTCATGTTGGAGACTTC -> GGTCATGTTGGAGACTTCA
AGATATATAGGCACGCGCG -> GATATATAGGCACGCGCGC
CCCCCAGTTTTTCCAGATG -> CCCCAGTTTTTCCAGATGC
ATGTTAACTACGATGCGGG -> TGTTAACTACGATGCGGGA
GTCGTCAAAACTCGCAACA -> TCGTCAAAACTCGCAACAG
TCAGCCCTAGTGTCTGTAA -> CAGCCCTAGTGTCTGTAAA
AGTGTCTGTAAATATCGGC -> GTGTCTGTAAATATCGGCT
GTCTGTAAATATCGGCTCT -> TCTGTAAATATCGGCTCTC
GCCGGGTCTGGGATGGCTT -> CCGGGTCTGGGATGGCTTC
CATAGACGCCGAGATAGAT -> ATAGACGCCGAGATAGATT
GAAGCAGCGATTGTACAAC -> AAGCAGCGATTGTACAACG
AGTGTTGGTATTGACCTGA -> GTGTTGGTATTGACCTGAT
TTAACTACGATGCGGGATT -> TAACTACGATGCGGGATTG
GTCACCACAAAGATCGCTC -> TCACCACAAAGATCGCTCG
TACTATTACTCTCAAGCCG -> ACTATTACTCTCAAGCCGC
GTCTATGTTTATTAGTATC -> TCTATGTTTATTAGTATCT
ATGGCGGTCCAGTGCCGCA -> TGGCGGTCCAGTGCCGCAG
TATTGCCGCTGGTGAACAA -> ATTGCCGCTGGTGAACAAT
GTGACCCCGACTCAGAGGT -> TGACCCCGACTCAGAGGTG
ACTAGTTAAGCTCGGCGTT -> CTAGTTAAGCTCGGCGTTT
ATTTGGTCTCTTTCCGGGA -> TTTGGTCTCTTTCCGGGAA
CCCGACTCTCAGACTTTCG -> CCGACTCTCAGACTTTCGC
TGCCACTCTTTAAGCAAAT -> GCCACTCTTTAAGCAAATT
CCGCAGATGGTAACTGATT -> CGCAGATGGTAACTGATTA
GTCCCGCGTCAAGTATTGG -> TCCCGCGTCAAGTATTGGT
TTACCATTTCGCGTCGCTG -> TACCATTTCGCGTCGCTGC
TGAATGTGCTGGATCACGT -> GAATGTGCTGGATCACGTG
GAACAATAGCCTGCGACAT -> AACAATAGCCTGCGACATA
ATTGTGAGGCGAAGCCGGT -> TTGTGAGGCGAAGCCGGTG
AAGATCGCTCGCACAACTC -> AGATCGCTCGCACAACTCA
CTTACGATGATACTGGACC -> TTACGATGATACTGGACCA
ATTAGAAGCAGCGATTGTA -> TTAGAAGCAGCGATTGTAC
GTGACCCCGACTGCAATGG -> TGACCCCGACTGCAATGGT
GTTTATTAGTATCTCTAGT -> TTTATTAGTATCTCTAGTC
AACTGATTATTACTATTAC -> ACTGATTATTACTATTACT
CCAGATGCCTACCGAAGGT -> CAGATGCCTACCGAAGGTT
CCAGAACGTTACGGTGTCC -> CAGAACGTTACGGTGTCCT
GGACTTTGGTTCGGTGACC -> GACTTTGGTTCGGTGACCC
CGCCCGCACGGTCCAGAAC -> GCCCGCACGGTCCAGAACG
GCGGGATTGCCGTTAGGGT -> CGGGATTGCCGTTAGGGTT
CATTTCGCGTCGCTGCACG -> ATTTCGCGTCGCTGCACGA
CGATCGCTGCCGTATTAGC -> GATCGCTGCCGTATTAGCT
ATTATTACTATTACTCTCA -> TTATTACTATTACTCTCAA
CCGATTAAGGAGGTCCTTG -> CGATTAAGGAGGTCCTTGC
CAGACTACATCGAGACAAG -> AGACTACATCGAGACAAGC
CCCGACTCAGAGGTGGATC -> CCGACTCAGAGGTGGATCC
TTAAGGAGGTCCTTGCAAG -> TAAGGAGGTCCTTGCAAGT
ATTACCCGAGAGTTAGATC -> TTACCCGAGAGTTAGATCA
CCCCCGCATTCTACGCGCT -> CCCCGCATTCTACGCGCTC
CAATAGCCTGCGACATACG -> AATAGCCTGCGACATACGG
CCATAAGTCGTCACGCGGA -> CATAAGTCGTCACGCGGAG
CTGCAATGGTGCGTTCCGA -> TGCAATGGTGCGTTCCGAT
GATACTGACCCCGGCCCCC -> ATACTGACCCCGGCCCCCT
AGCTCGGCGTTTAGCAATC -> GCTCGGCGTTTAGCAATCC
ATTGTACAACGAGTAGCGT -> TTGTACAACGAGTAGCGTC
CGCTCGCACAACTCAAAGC -> GCTCGCACAACTCAAAGCC
ATATAGGCACGCGCGCTCT -> TATAGGCACGCGCGCTCTC
CTCAAAGCCGCAGATGGTA -> TCAAAGCCGCAGATGGTAA
AACCGTGCATATTCAGAAT -> ACCGTGCATATTCAGAATA
GTAGGGTCGTCAAAACTCG -> TAGGGTCGTCAAAACTCGC
TATTGACCTGATGAGCACT -> ATTGACCTGATGAGCACTC
TGGTGAACAATAGCCTGCG -> GGTGAACAATAGCCTGCGA
TGCGAGCCGAAGCAGCTCT -> GCGAGCCGAAGCAGCTCTA
ACCGAAGGTTTAGAGATAT -> CCGAAGGTTTAGAGATATT
CCTTGAGTATTTTTCGATC -> CTTGAGTATTTTTCGATCT
TTTAGCAATCCTCGTAGCC -> TTAGCAATCCTCGTAGCCG
CCAGTGCCGCAGACTACAT -> CAGTGCCGCAGACTACATC
GGTGAACAATAGCCTGCGA -> GTGAACAATAGCCTGCGAC
AGGGAGATCCTGATAGGCA -> GGGAGATCCTGATAGGCAC
TTACCCGAGAGTTAGATCA -> TACCCGAGAGTTAGATCAT
AGTGATATACCAATATTTC -> GTGATATACCAATATTTCA
TCGCCCGTTCCCTTTCCTT -> CGCCCGTTCCCTTTCCTTG
GTCTCTTGATGGAGGGAGT -> TCTCTTGATGGAGGGAGTA
TGAGCCGGGTCTGGGATGG -> GAGCCGGGTCTGGGATGGC
TACCATTTCGCGTCGCTGC -> ACCATTTCGCGTCGCTGCA
GGGTCTCGGCTTACGATGA -> GGTCTCGGCTTACGATGAT
TGACCCCGACTCTCAGACT -> GACCCCGACTCTCAGACTT
AATGAGCCTGCGGCTTACC -> ATGAGCCTGCGGCTTACCG
CGGTCCAGTGCCGCAGACT -> GGTCCAGTGCCGCAGACTA
TGACCCCGACTGCAATGGT -> GACCCCGACTGCAATGGTG
TTGTACTAAACAACGAAAT -> TGTACTAAACAACGAAATC
GGCTATATTGCCGCTGGTG -> GCTATATTGCCGCTGGTGA
TATCTAGCGTCAGTGCTTA -> ATCTAGCGTCAGTGCTTAC
GGTCATGTTGGAGACTTCA -> GTCATGTTGGAGACTTCAA
GTTAAGCTCGGCGTTTAGC -> TTAAGCTCGGCGTTTAGCA
CCGACATCGAGTAAGTGGT -> CGACATCGAGTAAGTGGTC
GAACGTTACGGTGTCCTCC -> AACGTTACGGTGTCCTCCC
ACAAGCTAGTAGAAGGGGG -> CAAGCTAGTAGAAGGGGGT
AAGTGGTCACCTGGCGCTC -> AGTGGTCACCTGGCGCTCA
AACCCGCTCGGAGCGATCA -> ACCCGCTCGGAGCGATCAT
GACTTCGGCCGTCTAGGCA -> ACTTCGGCCGTCTAGGCAT
ACGTGGTCGTCCCGCGTCA -> CGTGGTCGTCCCGCGTCAA
TGACATAGACGCCGAGATA -> GACATAGACGCCGAGATAG
TTCTCTCCTGAGCCGGGTC -> TCTCTCCTGAGCCGGGTCT
GCGCCGTTCTTTATTGTAC -> CGCCGTTCTTTATTGTACT
GCCGTTAGGGTTTCTAACA -> CCGTTAGGGTTTCTAACAC
ACGCGCTCCCCCAGTAGGG -> CGCGCTCCCCCAGTAGGGT
TAGTGGCGCCGTTCTTTAT -> AGTGGCGCCGTTCTTTATT
CCCAGCGTGGACGGAACGA -> CCAGCGTGGACGGAACGAG
CGACATCGAGTAAGTGGTC -> GACATCGAGTAAGTGGTCA
TTGAATGTGCTGGATCACG -> TGAATGTGCTGGATCACGT
GATATACCAATATTTCATC -> ATATACCAATATTTCATCA
TTCCGGGAAATAAAAAAGT -> TCCGGGAAATAAAAAAGTG
TTTCGCGTCGCTGCACGAG -> TTCGCGTCGCTGCACGAGT
GATAGATTAACCCGAGCAT -> ATAGATTAACCCGAGCATA
GAAATTCAATGTAATCAGC -> AAATTCAATGTAATCAGCC
CCTGATGAGCACTCTATCT -> CTGATGAGCACTCTATCTC
TGATTATTACTATTACTCT -> GATTATTACTATTACTCTC
ACCCGAGAGTTAGATCATA -> CCCGAGAGTTAGATCATAG
ACGCTATGGCCACGGAGTC -> CGCTATGGCCACGGAGTCC
TCAAGGTGACAAGTATAAC -> CAAGGTGACAAGTATAACG
GCCCGGCTACAGCACGCCG -> CCCGGCTACAGCACGCCGC
TCAGTGCTCTGATAGACGT -> CAGTGCTCTGATAGACGTG
TGTCTGTAAATATCGGCTC -> GTCTGTAAATATCGGCTCT
CCAAGGCTATATTGCCGCT -> CAAGGCTATATTGCCGCTG
TTGGAGGGAGATCCTGATA -> TGGAGGGAGATCCTGATAG
GTCCAAAGCTGATATGGCG -> TCCAAAGCTGATATGGCGG
AGAGGTGGATCCATTGTGA -> GAGGTGGATCCATTGTGAG
AGCGGCAACGAGCACTCGT -> GCGGCAACGAGCACTCGTC
TACTAGTTAAGCTCGGCGT -> ACTAGTTAAGCTCGGCGTT
AAGTACAGTTATGTCGGTA -> AGTACAGTTATGTCGGTAG
TGTATCTGCCTCGCCCGTT -> GTATCTGCCTCGCCCGTTC
GATTGTGGTCAGCTAGCCG -> ATTGTGGTCAGCTAGCCGG
GACTTGGCGTGTAAGTCCA -> ACTTGGCGTGTAAGTCCAA
AAGATGGATTCGCCCGCAC -> AGATGGATTCGCCCGCACG
CAGGAAGTTCTAGGGTCAT -> AGGAAGTTCTAGGGTCATG
GAGTAGACCCCCCAGTTTT -> AGTAGACCCCCCAGTTTTT
GATATGGCGGTCCAGTGCC -> ATATGGCGGTCCAGTGCCG
CGAAGCGTAAAGATATTTT -> GAAGCGTAAAGATATTTTT
ATTTATCTAGCGTCAGTGC -> TTTATCTAGCGTCAGTGCT
ATCTCAGGCTGTGACTTTC -> TCTCAGGCTGTGACTTTCT
AGCGTGGACGGAACGAGTA -> GCGTGGACGGAACGAGTAA
AGCTTACGATGATACTGGA -> GCTTACGATGATACTGGAA
GTGCGTTCCGATTGTGGTC -> TGCGTTCCGATTGTGGTCA
CTATCTCACGATGCACCCC -> TATCTCACGATGCACCCCA
CAGCACGCCGCCACGACAA -> AGCACGCCGCCACGACAAT
TCGGCGTTTAGCAATCCTC -> CGGCGTTTAGCAATCCTCG
CTGCGGCTTACCGATTAAG -> TGCGGCTTACCGATTAAGG
CGATGCACCCCACAGAAGT -> GATGCACCCCACAGAAGTA
ATAACGGAAATTCAATGTA -> TAACGGAAATTCAATGTAA
GATTATTACTATTACTCTC -> ATTATTACTATTACTCTCA
CGGGCCAAGGCTATATTGC -> GGGCCAAGGCTATATTGCC
GCACGGACTTTGGTTCGGT -> CACGGACTTTGGTTCGGTG
TGGCGTCACCACAAAGATC -> GGCGTCACCACAAAGATCG
GGAGTCCTATTCTATTGGT -> GAGTCCTATTCTATTGGTA
GCTGCCCCGAGTCGCCCAG -> CTGCCCCGAGTCGCCCAGG
ATGAGCACTCTATCTCACG -> TGAGCACTCTATCTCACGA
GATATTTTTAGTTTTATAA -> ATATTTTTAGTTTTATAAG
ACGCCGCCACGACAATTCT -> CGCCGCCACGACAATTCTC
TATTCTATTGGTACACATA -> ATTCTATTGGTACACATAA
CCTTATAGCAAATTCAAGG -> CTTATAGCAAATTCAAGGT
TTGGAGACTTCAACCGTCT -> TGGAGACTTCAACCGTCTC
TCGGTAGACTAAGGTGTAG -> CGGTAGACTAAGGTGTAGA
TCAGTGCTTACGATGATAC -> CAGTGCTTACGATGATACT
GTATCGGTTCGTCGATTTT -> TATCGGTTCGTCGATTTTC
GTGTAGAAGCAATGGCTAG -> TGTAGAAGCAATGGCTAGT
TGTGAGGCGAAGCCGGTGG -> GTGAGGCGAAGCCGGTGGC
CTAGTAACATTTGGTCTCT -> TAGTAACATTTGGTCTCTT
GACCGGGTTTGGGCAAGTA -> ACCGGGTTTGGGCAAGTAA
GAAGCCGGTGGCGTCACCA -> AAGCCGGTGGCGTCACCAC
CGCAGATGGTAACTGATTA -> GCAGATGGTAACTGATTAT
CCTAGTGTCTGTAAATATC -> CTAGTGTCTGTAAATATCG
CAACGAGCACTCGTCTATG -> AACGAGCACTCGTCTATGT
AAGATAATTGACCTGAAGC -> AGATAATTGACCTGAAGCA
CGAAGCCGGTGGCGTCACC -> GAAGCCGGTGGCGTCACCA
AAGGTGTAGAAGCAATGGC -> AGGTGTAGAAGCAATGGCT
CGTCGATTTTCGAGAGACC -> GTCGATTTTCGAGAGACCG
GCCCCCTGTATCTGCCTCG -> CCCCCTGTATCTGCCTCGC
TGGGGTCACCTCCTTTTTA -> GGGGTCACCTCCTTTTTAA
ATGTGACAAGTGGTTCGGT -> TGTGACAAGTGGTTCGGTG
ACAGAAGTACGGTTCTCGA -> CAGAAGTACGGTTCTCGAT
TACTAAACAACGAAATCAC -> ACTAAACAACGAAATCACC
GGTCTCGGCTTACGATGAT -> GTCTCGGCTTACGATGATA
CGAGTGTATCGGTTCGTCG -> GAGTGTATCGGTTCGTCGA
CTGTGTTCGATCACATCAA -> TGTGTTCGATCACATCAAA
CTTATAGCAAATTCAAGGT -> TTATAGCAAATTCAAGGTG
AGCCGGGTCTGGGATGGCT -> GCCGGGTCTGGGATGGCTT
ATAGACGTGCCCGGCTACA -> TAGACGTGCCCGGCTACAG
AGTTAAGCTCGGCGTTTAG -> GTTAAGCTCGGCGTTTAGC
CGGCGTTTAGCAATCCTCG -> GGCGTTTAGCAATCCTCGT
CCTTTCCTTGAATGTGCTG -> CTTTCCTTGAATGTGCTGG
AAGCAGACTTCGGCCGTCT -> AGCAGACTTCGGCCGTCTA
CAGCGTGGACGGAACGAGT -> AGCGTGGACGGAACGAGTA
CGTTCTTTATTGTACTAAA -> GTTCTTTATTGTACTAAAC
ACTCCAAGTGATATACCAA -> CTCCAAGTGATATACCAAT
CGCGCTCTCTAATAGACAT -> GCGCTCTCTAATAGACATG
TGGCGTGTAAGTCCAAAGC -> GGCGTGTAAGTCCAAAGCT
CTGATGAGCACTCTATCTC -> TGATGAGCACTCTATCTCA
TATGGTTCGGTGACCCCGA -> ATGGTTCGGTGACCCCGAC,ATGGTTCGGTGACCCCGAC
TGCAATGGTGCGTTCCGAT -> GCAATGGTGCGTTCCGATT
GACTACATCGAGACAAGCT -> ACTACATCGAGACAAGCTA
TACGGTTCTCGATCCTAAC -> ACGGTTCTCGATCCTAACC
GCAATCCTCGTAGCCGAAG -> CAATCCTCGTAGCCGAAGC
CTCTTTAAGCAAATTTTTA -> TCTTTAAGCAAATTTTTAA
AAGTGTTGGTATTGACCTG -> AGTGTTGGTATTGACCTGA
GGTTTAGAGATATTCACAT -> GTTTAGAGATATTCACATA
GGCGTCACCACAAAGATCG -> GCGTCACCACAAAGATCGC
CCGGGATTAGAAGCAGCGA -> CGGGATTAGAAGCAGCGAT
GGTTTCTAACACACTGGGT -> GTTTCTAACACACTGGGTA
TTCAGAATAAGCGGCAACG -> TCAGAATAAGCGGCAACGA
TTGCCGCTGGTGAACAATA -> TGCCGCTGGTGAACAATAG
ACGAGCACTCGTCTATGTT -> CGAGCACTCGTCTATGTTT
TTGTACAACGAGTAGCGTC -> TGTACAACGAGTAGCGTCG
CTGGAGATGTGACAAGTGG -> TGGAGATGTGACAAGTGGT
AGATGTGACAAGTGGTTCG -> GATGTGACAAGTGGTTCGG
GAACGAGTAAAATACGATA -> AACGAGTAAAATACGATAC
TAGTCGCATTATTAACAAG -> AGTCGCATTATTAACAAGT
ACATCAAACGCTATGGCCA -> CATCAAACGCTATGGCCAC
GACGATCGCTGCCGTATTA -> ACGATCGCTGCCGTATTAG
GGAGATCCTGATAGGCACA -> GAGATCCTGATAGGCACAC
ACGATGATACTGGATGCAC -> CGATGATACTGGATGCACG
GGGGTGACGGGCCAAGGCT -> GGGTGACGGGCCAAGGCTA
GAAGCGTAAAGATATTTTT -> AAGCGTAAAGATATTTTTA
TTTATCTAGCGTCAGTGCT -> TTATCTAGCGTCAGTGCTT
AGACTATACTGCTGCCACT -> GACTATACTGCTGCCACTC
CCGCATTCTACGCGCTCCC -> CGCATTCTACGCGCTCCCC
ACGAATACAATACTAGTTA -> CGAATACAATACTAGTTAA
GTTCGATCACATCAAACGC -> TTCGATCACATCAAACGCT
CACGGAGTCCTATTCTATT -> ACGGAGTCCTATTCTATTG
GCATATCCGACATCGAGTA -> CATATCCGACATCGAGTAA
AGGGTCATGTTGGAGACTT -> GGGTCATGTTGGAGACTTC
GAGCATATCCGACATCGAG -> AGCATATCCGACATCGAGT
CGCAGACTACATCGAGACA -> GCAGACTACATCGAGACAA
TTACTCTCAAGCCGCCCTT -> TACTCTCAAGCCGCCCTTG
TTTAGTTTTATAAGTGTTG -> TTAGTTTTATAAGTGTTGG
AAGTGGCCCAGCGTGGACG -> AGTGGCCCAGCGTGGACGG
CAATGGCTAGTAACATTTG -> AATGGCTAGTAACATTTGG
CGAGTAAAATACGATACTG -> GAGTAAAATACGATACTGA
GTTCTTTATTGTACTAAAC -> TTCTTTATTGTACTAAACA
GGACCAACCCTGTATGGTT -> GACCAACCCTGTATGGTTC
ATCGCTCGCACAACTCAAA -> TCGCTCGCACAACTCAAAG
TCCCGCGTCAAGTATTGGT -> CCCGCGTCAAGTATTGGTC
TATTTTTCGATCTCTGGAC -> ATTTTTCGATCTCTGGACC
TTTATTAGTATCTCTAGTC -> TTATTAGTATCTCTAGTCG
AGCTAGCCGGTGGCCGTTA -> GCTAGCCGGTGGCCGTTAC
CTTTTTAAGCATACGATTA -> TTTTTAAGCATACGATTAA
TCCTGATAGGCACACTGTG -> CCTGATAGGCACACTGTGT
CTCCTGAGCCGGGTCTGGG -> TCCTGAGCCGGGTCTGGGA
AAGTTCTAGGGTCATGTTG -> AGTTCTAGGGTCATGTTGG
CCCGCTCGGAGCGATCATA -> CCGCTCGGAGCGATCATAG
AGTAGGGTCGTCAAAACTC -> GTAGGGTCGTCAAAACTCG
TCAACCGTCTCTTGATGGA -> CAACCGTCTCTTGATGGAG
AGTAGAAGGGGGTGACGGG -> GTAGAAGGGGGTGACGGGC
TAGCCATCTCAGGCTGTGA -> AGCCATCTCAGGCTGTGAC
GAGGGAGTAGACCCCCCAG -> AGGGAGTAGACCCCCCAGT
CGGTGACCCCGACTCAGAG -> GGTGACCCCGACTCAGAGG
CCGATTGTGGTCAGCTAGC -> CGATTGTGGTCAGCTAGCC
GGAGGGAGTAGACCCCCCA -> GAGGGAGTAGACCCCCCAG
TTGAGTATTTTTCGATCTC -> TGAGTATTTTTCGATCTCT
CGTCACGCGGAGCCCTGCG -> GTCACGCGGAGCCCTGCGG
ACTCAGAGGTGGATCCATT -> CTCAGAGGTGGATCCATTG
GATATATAGGCACGCGCGC -> ATATATAGGCACGCGCGCT
AAATATCGGCTCTCCGGGA -> AATATCGGCTCTCCGGGAT
GTAACCCGCTCGGAGCGAT -> TAACCCGCTCGGAGCGATC
CAATATTTCATCAGTGCTC -> AATATTTCATCAGTGCTCT
CACTGGGTATAGTAAAACC -> ACTGGGTATAGTAAAACCG
ACAACAAGATGGATTCGCC -> CAACAAGATGGATTCGCCC
CCACGCTTACGATGATACT -> CACGCTTACGATGATACTG
CGCCACGACAATTCTCTCC -> GCCACGACAATTCTCTCCT
GTACAGTTATGTCGGTAGA -> TACAGTTATGTCGGTAGAC
GGTCGTCAAAACTCGCAAC -> GTCGTCAAAACTCGCAACA
AATAAAAAAGTGGCCCAGC -> ATAAAAAAGTGGCCCAGCG
TCACATCAAACGCTATGGC -> CACATCAAACGCTATGGCC
TGTAAATATCGGCTCTCCG -> GTAAATATCGGCTCTCCGG
GTTTAGCAATCCTCGTAGC -> TTTAGCAATCCTCGTAGCC
GCCGGTGGCCGTTACACCC -> CCGGTGGCCGTTACACCCC
GAAGCGGTCACACGTAACC -> AAGCGGTCACACGTAACCC
TAGGGTTTCTAACACACTG -> AGGGTTTCTAACACACTGG
AGGTCCTTGCAAGTAGAGG -> GGTCCTTGCAAGTAGAGGT
AGAAGTACGGTTCTCGATC -> GAAGTACGGTTCTCGATCC
TTACGGTGTCCTCCCCCCG -> TACGGTGTCCTCCCCCCGC
CTGGTGAACAATAGCCTGC -> TGGTGAACAATAGCCTGCG
CGGGTCTGGGATGGCTTCC -> GGGTCTGGGATGGCTTCCT
TAGGCACACTGTGTTCGAT -> AGGCACACTGTGTTCGATC
TGGGATGGCTTCCTGACTA -> GGGATGGCTTCCTGACTAT
CGGAGCCCTGCGGTTGATT -> GGAGCCCTGCGGTTGATTT
CGGAGTCCTATTCTATTGG -> GGAGTCCTATTCTATTGGT
CCGGGAAATAAAAAAGTGG -> CGGGAAATAAAAAAGTGGC
AGACGCCGAGATAGATTAA -> GACGCCGAGATAGATTAAC
TTACACCCCGCCCGACGAT -> TACACCCCGCCCGACGATC
AATTCAATGTAATCAGCCC -> ATTCAATGTAATCAGCCCT
CTACCGAAGGTTTAGAGAT -> TACCGAAGGTTTAGAGATA
AGCCATCTCAGGCTGTGAC -> GCCATCTCAGGCTGTGACT
GTACGGTTCTCGATCCTAA -> TACGGTTCTCGATCCTAAC
GTGCACAAAGAACAGAAGA -> TGCACAAAGAACAGAAGAG
GCACTCGTCTATGTTTATT -> CACTCGTCTATGTTTATTA
GTAAGTGGTCACCTGGCGC -> TAAGTGGTCACCTGGCGCT
AGACTTCAACCGTCTCTTG -> GACTTCAACCGTCTCTTGA
AGTCCAAAGCTGATATGGC -> GTCCAAAGCTGATATGGCG
CACCTTGTAAGTTTAGCTT -> ACCTTGTAAGTTTAGCTTA
AAGTAATTTCACTTAGCAC -> AGTAATTTCACTTAGCACC
TATCGGCTCTCCGGGATTA -> ATCGGCTCTCCGGGATTAG
CGATCCTAACCATAAGTCG -> GATCCTAACCATAAGTCGT
GTCTAGTGGCGCCGTTCTT -> TCTAGTGGCGCCGTTCTTT
CACCTTATAGCAAATTCAA -> ACCTTATAGCAAATTCAAG
AGTAAAATACGATACTGAC -> GTAAAATACGATACTGACC
TATTCTTGGAGGGAGATCC -> ATTCTTGGAGGGAGATCCT
ATGTAATCAGCCCTAGTGT -> TGTAATCAGCCCTAGTGTC
CCCCACCCGCCGAAGTACA -> CCCACCCGCCGAAGTACAG
GCGACCCCCCACCCGCCGA -> CGACCCCCCACCCGCCGAA
TAGACTATACTGCTGCCAC -> AGACTATACTGCTGCCACT
CTAACGAATACAATACTAG -> TAACGAATACAATACTAGT
TCAAGTATTGGTCTAGTGG -> CAAGTATTGGTCTAGTGGC
GCTAGTTCTAAATTACCCG -> CTAGTTCTAAATTACCCGA
TATTTCATCAGTGCTCTGA -> ATTTCATCAGTGCTCTGAT
CACGCGGAGCCCTGCGGTT -> ACGCGGAGCCCTGCGGTTG
GTGGCCCAGCGTGGACGGA -> TGGCCCAGCGTGGACGGAA
ACTGATTATTACTATTACT -> CTGATTATTACTATTACTC
TAGCAATCCTCGTAGCCGA -> AGCAATCCTCGTAGCCGAA
CGGTGGCGTCACCACAAAG -> GGTGGCGTCACCACAAAGA
CGCTGGTGAACAATAGCCT -> GCTGGTGAACAATAGCCTG
GCCCCGAGTCGCCCAGGCC -> CCCCGAGTCGCCCAGGCCA
GCTTCCTGACTATGTTAAC -> CTTCCTGACTATGTTAACT
CAAAGCCGCAGATGGTAAC -> AAAGCCGCAGATGGTAACT
TGGTCTCTTTCCGGGAAAT -> GGTCTCTTTCCGGGAAATA
TTATGTCGGTAGACTAAGG -> TATGTCGGTAGACTAAGGT
GATACTGGAGATGTGACAA -> ATACTGGAGATGTGACAAG
GTAGCTTGTGCACAAAGAA -> TAGCTTGTGCACAAAGAAC
CGAAGGTTTAGAGATATTC -> GAAGGTTTAGAGATATTCA
TCGATTTTCGAGAGACCGG -> CGATTTTCGAGAGACCGGG
CCCCGACTGCAATGGTGCG -> CCCGACTGCAATGGTGCGT
AGCCGGTGGCGTCACCACA -> GCCGGTGGCGTCACCACAA
AACGGAAATTCAATGTAAT -> ACGGAAATTCAATGTAATC
ATTACCATTTCGCGTCGCT -> TTACCATTTCGCGTCGCTG
TCTGATAGACGTGCCCGGC -> CTGATAGACGTGCCCGGCT
TAGAAGCAGCGATTGTACA -> AGAAGCAGCGATTGTACAA
ACGGGCCAAGGCTATATTG -> CGGGCCAAGGCTATATTGC
CGGAAATTCAATGTAATCA -> GGAAATTCAATGTAATCAG
TCCGATTGTGGTCAGCTAG -> CCGATTGTGGTCAGCTAGC
TATGGCGGTCCAGTGCCGC -> ATGGCGGTCCAGTGCCGCA
GGAAATAAAAAAGTGGCCC -> GAAATAAAAAAGTGGCCCA
GAGTCCTATTCTATTGGTA -> AGTCCTATTCTATTGGTAC
TAATGTGCGAGCCGAAGCA -> AATGTGCGAGCCGAAGCAG
GTGACGGGCCAAGGCTATA -> TGACGGGCCAAGGCTATAT
GCGGTTGATTTATCTAGCG -> CGGTTGATTTATCTAGCGT
CTCAGGCTGTGACTTTCTA -> TCAGGCTGTGACTTTCTAA
ATACTAGTTAAGCTCGGCG -> TACTAGTTAAGCTCGGCGT
GGGTTTCTAACACACTGGG -> GGTTTCTAACACACTGGGT
TTTTAAGCATACGATTAAT -> TTTAAGCATACGATTAATG
CGCATGCACCTTATAGCAA -> GCATGCACCTTATAGCAAA
AAAGCCGCAGATGGTAACT -> AAGCCGCAGATGGTAACTG
GCACAAAGAACAGAAGAGA -> CACAAAGAACAGAAGAGAT
AGATCGCTCGCACAACTCA -> GATCGCTCGCACAACTCAA
CCCCAGTTTTTCCAGATGC -> CCCAGTTTTTCCAGATGCC
CTCCCCCCGCATTCTACGC -> TCCCCCCGCATTCTACGCG
CCATTTAGCTAGTTCTAAA -> CATTTAGCTAGTTCTAAAT
GCCATCTCAGGCTGTGACT -> CCATCTCAGGCTGTGACTT
CGACTCTCAGACTTTCGCA -> GACTCTCAGACTTTCGCAT
GCCCTAGTGTCTGTAAATA -> CCCTAGTGTCTGTAAATAT
GCGTGGACGGAACGAGTAA -> CGTGGACGGAACGAGTAAA
ATATTTATTCTTGGAGGGA -> TATTTATTCTTGGAGGGAG
ACATATTTATTCTTGGAGG -> CATATTTATTCTTGGAGGG
CCGAAGGTTTAGAGATATT -> CGAAGGTTTAGAGATATTC
ACATAATGTGCGAGCCGAA -> CATAATGTGCGAGCCGAAG
AGCAGACTTCGGCCGTCTA -> GCAGACTTCGGCCGTCTAG
CGCCCGACGATCGCTGCCG -> GCCCGACGATCGCTGCCGT
CTTGCAAGTAGAGGTAAGT -> TTGCAAGTAGAGGTAAGTG
ACCGGGTTTGGGCAAGTAA -> CCGGGTTTGGGCAAGTAAT
ACTGGGTATAGTAAAACCG -> CTGGGTATAGTAAAACCGT
CGTAACCCGCTCGGAGCGA -> GTAACCCGCTCGGAGCGAT
TTGTAAGTTTAGCTTACGA -> TGTAAGTTTAGCTTACGAT
GTTCGTCGATTTTCGAGAG -> TTCGTCGATTTTCGAGAGA
CAAACGCTATGGCCACGGA -> AAACGCTATGGCCACGGAG
GCCTGCGGCTTACCGATTA -> CCTGCGGCTTACCGATTAA
TAGCCGGTGGCCGTTACAC -> AGCCGGTGGCCGTTACACC
TAGCTGCCCCGAGTCGCCC -> AGCTGCCCCGAGTCGCCCA
CGGTGGCCGTTACACCCCG -> GGTGGCCGTTACACCCCGC
