AAAAAATATTTCCACCCCG -> AAAAATATTTCCACCCCGG
AAAAATATTTCCACCCCGG -> AAAATATTTCCACCCCGGA
AAAAATGCGTGTCTCGAAT -> AAAATGCGTGTCTCGAATT
AAAACACGCTGTAAGTCTC -> AAACACGCTGTAAGTCTCA
AAAACATCTATGTCTGTTT -> AAACATCTATGTCTGTTTT
AAAACCTTACTTGGAGGCA -> AAACCTTACTTGGAGGCAC
AAAACTAAAAAATATTTCC -> AAACTAAAAAATATTTCCA
AAAAGGAGACCATGCTCTT -> AAAGGAGACCATGCTCTTT
AAAATATTTCCACCCCGGA -> AAATATTTCCACCCCGGAA
AAAATGCGTGTCTCGAATT -> AAATGCGTGTCTCGAATTC
AAACACGCTGTAAGTCTCA -> AACACGCTGTAAGTCTCAG
AAACATCTATGTCTGTTTT -> AACATCTATGTCTGTTTTG
AAACCAATGCTCGCAGAGA -> AACCAATGCTCGCAGAGAA
AAACCTACTTTCTTGTTTC -> AACCTACTTTCTTGTTTCG
AAACCTTACTTGGAGGCAC -> AACCTTACTTGGAGGCACA
AAACCTTATGCCTAGAAAG -> AACCTTATGCCTAGAAAGG
AAACGGTTCTGAAATAAGA -> AACGGTTCTGAAATAAGAG
AAACGTCAACGCCCCTCGA -> AACGTCAACGCCCCTCGAT
AAACTAAAAAATATTTCCA -> AACTAAAAAATATTTCCAC
AAACTCTTTAATAGATCCG -> AACTCTTTAATAGATCCGC
AAAGAATGCGTTGCTAAGC -> AAGAATGCGTTGCTAAGCG
AAAGACGCACTCCAATCTG -> AAGACGCACTCCAATCTGG
AAAGCCAAACCTACTTTCT -> AAGCCAAACCTACTTTCTT
AAAGGAGACCATGCTCTTT -> AAGGAGACCATGCTCTTTC
AAAGGCACTAATACCGAGG -> AAGGCACTAATACCGAGGC
AAAGGCGCGCGGATTCCGT -> AAGGCGCGCGGATTCCGTT
AAAGGCGTGAGTCGTGTCC -> AAGGCGTGAGTCGTGTCCC
AAAGGTGGATGAGTTCGGG -> AAGGTGGATGAGTTCGGGC
AAAGTATGGTCTTGTAGTA -> AAGTATGGTCTTGTAGTAC
AAATAAGAGACAGGTTCTG -> AATAAGAGACAGGTTCTGG
AAATACTGCAGGCAACCCT -> AATACTGCAGGCAACCCTG
AAATATTTCCACCCCGGAA -> AATATTTCCACCCCGGAAA
AAATCGCCTGTATCACGCC -> AATCGCCTGTATCACGCCG
AAATCTTGTGAGCATGGGT -> AATCTTGTGAGCATGGGTT
AAATCTTGTGAGCCAGTTG -> AATCTTGTGAGCCAGTTGT
AAATCTTGTGAGCGGATTT -> AATCTTGTGAGCGGATTTG
AAATCTTGTGAGCTTGTTG -> AATCTTGTGAGCTTGTTGT
AAATGCGCCACGTGTAGGA -> AATGCGCCACGTGTAGGAC
AAATGCGTGTCTCGAATTC -> AATGCGTGTCTCGAATTCG
AAATGTTCTAGGGGAATTC -> AATGTTCTAGGGGAATTCG
AAATTTCTTCATGAGTCGG -> AATTTCTTCATGAGTCGGT
AACAAAGTATGGTCTTGTA -> ACAAAGTATGGTCTTGTAG
AACAAATCTTGTGAGCATG -> ACAAATCTTGTGAGCATGG
AACAAATCTTGTGAGCCAG -> ACAAATCTTGTGAGCCAGT
AACAAATCTTGTGAGCGGA -> ACAAATCTTGTGAGCGGAT
AACAAATCTTGTGAGCTTG -> ACAAATCTTGTGAGCTTGT
AACAAGGCCGAGACAGACC -> ACAAGGCCGAGACAGACCG
AACACGCTGTAAGTCTCAG -> ACACGCTGTAAGTCTCAGG
AACACGTTATGTAAAAGGA -> ACACGTTATGTAAAAGGAG
AACACTATGAAACCTTATG -> ACACTATGAAACCTTATGC
AACAGGGGCTTTTACCTTA -> ACAGGGGCTTTTACCTTAA
AACAGTCCAACAAATCTTG -> ACAGTCCAACAAATCTTGT
AACAGTTCTCCGAGTTCCA -> ACAGTTCTCCGAGTTCCAA
AACATCTATGTCTGTTTTG -> ACATCTATGTCTGTTTTGG
AACATGATTACGAACCTGT -> ACATGATTACGAACCTGTC
AACATGTTTCGATTAAGTT -> ACATGTTTCGATTAAGTTC
AACATTGCAGTGATTCAAT -> ACATTGCAGTGATTCAATC
AACCAATGCTCGCAGAGAA -> ACCAATGCTCGCAGAGAAC
AACCACACTCCCCGATCCA -> ACCACACTCCCCGATCCAT
AACCCTGGTAGTGCCCCAA -> ACCCTGGTAGTGCCCCAAA
AACCTACTTTCTTGTTTCG -> ACCTACTTTCTTGTTTCGG
AACCTGTCGCATCGGCCGG -> ACCTGTCGCATCGGCCGGA
AACCTTACTTGGAGGCACA -> ACCTTACTTGGAGGCACAA
AACCTTATGCCTAGAAAGG -> ACCTTATGCCTAGAAAGGC
AACGCCCCTCGATGGTATA -> ACGCCCCTCGATGGTATAT
AACGCGCTTTTGTAGCCGA -> ACGCGCTTTTGTAGCCGAA
AACGGTTCTGAAATAAGAG -> ACGGTTCTGAAATAAGAGA
AACGTCAACGCCCCTCGAT -> ACGTCAACGCCCCTCGATG
AACGTCCACACGGCCCCCT -> ACGTCCACACGGCCCCCTG
AACTAAAAAATATTTCCAC -> ACTAAAAAATATTTCCACC
AACTACATTGTGACTGCTG -> ACTACATTGTGACTGCTGC
AACTAGTAGAATTGTAAAG -> ACTAGTAGAATTGTAAAGA
AACTCGCTGCCCCGACTAA -> ACTCGCTGCCCCGACTAAT
AACTCTTTAATAGATCCGC -> ACTCTTTAATAGATCCGCG
AACTGGCGGAACGCGCTTT -> ACTGGCGGAACGCGCTTTT
AACTTATTGAGCCCGCGTC -> ACTTATTGAGCCCGCGTCC
AACTTGAGGACTTACTTCT -> ACTTGAGGACTTACTTCTG
AAGAAATGTTCTAGGGGAA -> AGAAATGTTCTAGGGGAAT
AAGAACAAGGCCGAGACAG -> AGAACAAGGCCGAGACAGA
AAGAATGCGTTGCTAAGCG -> AGAATGCGTTGCTAAGCGC
AAGAATTCGGGCGTTTTAC -> AGAATTCGGGCGTTTTACG
AAGACGCACTCCAATCTGG -> AGACGCACTCCAATCTGGA
AAGAGACAGGTTCTGGTGG -> AGAGACAGGTTCTGGTGGC
AAGAGCCAAAGGCGCGCGG -> AGAGCCAAAGGCGCGCGGA
AAGCCAAACCTACTTTCTT -> AGCCAAACCTACTTTCTTG
AAGCGCACACCCTCCCTGG -> AGCGCACACCCTCCCTGGA
AAGGAGACCATGCTCTTTC -> AGGAGACCATGCTCTTTCT
AAGGCACTAATACCGAGGC -> AGGCACTAATACCGAGGCA
AAGGCCGAGACAGACCGCA -> AGGCCGAGACAGACCGCAT
AAGGCGCGCGGATTCCGTT -> AGGCGCGCGGATTCCGTTC
AAGGCGTGAGTCGTGTCCC -> AGGCGTGAGTCGTGTCCCG
AAGGGAAGTACCGAATAAC -> AGGGAAGTACCGAATAACA
AAGGTGGATGAGTTCGGGC -> AGGTGGATGAGTTCGGGCT
AAGGTGTCTGAAGAATTCG -> AGGTGTCTGAAGAATTCGG
AAGTACCGAATAACAAAGT -> AGTACCGAATAACAAAGTA
AAGTAGCTTCCAACTGGCG -> AGTAGCTTCCAACTGGCGG
AAGTATGGTCTTGTAGTAC -> AGTATGGTCTTGTAGTACT
AAGTCTCAGGTGATAGATT -> AGTCTCAGGTGATAGATTG
AAGTTCTGAAAAATGCGTG -> AGTTCTGAAAAATGCGTGT
AATAACAAAGTATGGTCTT -> ATAACAAAGTATGGTCTTG
AATAAGAGACAGGTTCTGG -> ATAAGAGACAGGTTCTGGT
AATAATGTTAGCGCCCTTC -> ATAATGTTAGCGCCCTTCA
AATACCGAGGCATAGGGCT -> ATACCGAGGCATAGGGCTG
AATACTGCAGGCAACCCTG -> ATACTGCAGGCAACCCTGG
AATAGAAATACTGCAGGCA -> ATAGAAATACTGCAGGCAA
AATAGATCCGCGAAAGAAT -> ATAGATCCGCGAAAGAATG
AATAGCCATTGTGAATTCG -> ATAGCCATTGTGAATTCGG
AATAGTTGTCGTTTAAACG -> ATAGTTGTCGTTTAAACGG
AATATTTCCACCCCGGAAA -> ATATTTCCACCCCGGAAAG
AATATTTGGATATCGGTTG -> ATATTTGGATATCGGTTGA
AATCATTGGTACTTGGTCA -> ATCATTGGTACTTGGTCAG
AATCGCACATTAAAGGTGG -> ATCGCACATTAAAGGTGGA
AATCGCCGGATATTGGATC -> ATCGCCGGATATTGGATCG
AATCGCCTGTATCACGCCG -> ATCGCCTGTATCACGCCGC
AATCTGGAGTAATGCAAGC -> ATCTGGAGTAATGCAAGCT
AATCTTACTCTTTACTTTT -> ATCTTACTCTTTACTTTTG
AATCTTGTGAGCATGGGTT -> ATCTTGTGAGCATGGGTTA
AATCTTGTGAGCCAGTTGT -> ATCTTGTGAGCCAGTTGTA
AATCTTGTGAGCGGATTTG -> ATCTTGTGAGCGGATTTGT
AATCTTGTGAGCTTGTTGT -> ATCTTGTGAGCTTGTTGTT
AATGCGCCACGTGTAGGAC -> ATGCGCCACGTGTAGGACA
AATGCGCCGACCGTGCTTA -> ATGCGCCGACCGTGCTTAA
AATGCGTGTCTCGAATTCG -> ATGCGTGTCTCGAATTCGG
AATGCGTTGCTAAGCGCAC -> ATGCGTTGCTAAGCGCACA
AATGCTCGCAGAGAACTCG -> ATGCTCGCAGAGAACTCGC
AATGTCGTCTCTGAAAACC -> ATGTCGTCTCTGAAAACCT
AATGTTAGCGCCCTTCAAT -> ATGTTAGCGCCCTTCAATT
AATGTTCTAGGGGAATTCG -> ATGTTCTAGGGGAATTCGG
AATTAACATGATTACGAAC -> ATTAACATGATTACGAACC
AATTAGCTGAGCAGGCCAC -> ATTAGCTGAGCAGGCCACG
AATTCGGGCGTTTTACGAC -> ATTCGGGCGTTTTACGACG
AATTCGGGCGTTTTACGCC -> ATTCGGGCGTTTTACGCCT
AATTCGGGCGTTTTACGGA -> ATTCGGGCGTTTTACGGAC
AATTCGGGCGTTTTACGTG -> ATTCGGGCGTTTTACGTGA
AATTGTAAAGACGCACTCC -> ATTGTAAAGACGCACTCCA
AATTTCCACTCGCGTGTCA -> ATTTCCACTCGCGTGTCAC
AATTTCTTCATGAGTCGGT -> ATTTCTTCATGAGTCGGTC
AATTTTCGGTTCCTCCTAC -> ATTTTCGGTTCCTCCTACT
ACAAAGTATGGTCTTGTAG -> CAAAGTATGGTCTTGTAGT
ACAAATCTTGTGAGCATGG -> CAAATCTTGTGAGCATGGG
ACAAATCTTGTGAGCCAGT -> CAAATCTTGTGAGCCAGTT
ACAAATCTTGTGAGCGGAT -> CAAATCTTGTGAGCGGATT
ACAAATCTTGTGAGCTTGT -> CAAATCTTGTGAGCTTGTT
ACAAATGCGCCACGTGTAG -> CAAATGCGCCACGTGTAGG
ACAACTTATTGAGCCCGCG -> CAACTTATTGAGCCCGCGT
ACAAGGCCGAGACAGACCG -> CAAGGCCGAGACAGACCGC
ACAATAATGTTAGCGCCCT -> CAATAATGTTAGCGCCCTT
ACACCCTCCCTGGAATCTT -> CACCCTCCCTGGAATCTTA
ACACCTAGTTCCAACAAAT -> CACCTAGTTCCAACAAATC
ACACGAATATTTGGATATC -> CACGAATATTTGGATATCG
ACACGCTGTAAGTCTCAGG -> CACGCTGTAAGTCTCAGGT
ACACGGCCCCCTGTAGTGC -> CACGGCCCCCTGTAGTGCT
ACACGTTATGTAAAAGGAG -> CACGTTATGTAAAAGGAGA
ACACTACTCCTTTGCCACA -> CACTACTCCTTTGCCACAG
ACACTATGAAACCTTATGC -> CACTATGAAACCTTATGCC
ACACTCCCCGATCCATTGC -> CACTCCCCGATCCATTGCG
ACAGACCGCATCACGAGAA -> CAGACCGCATCACGAGAAG
ACAGCCTGGCACTAGGATC -> CAGCCTGGCACTAGGATCC
ACAGCTAGGGTCCAACAAA -> CAGCTAGGGTCCAACAAAT
ACAGCTAGTAGGAATAGTT -> CAGCTAGTAGGAATAGTTG
ACAGGATCAGGACGATTCG -> CAGGATCAGGACGATTCGA
ACAGGGGCTTTTACCTTAA -> CAGGGGCTTTTACCTTAAC
ACAGGTTCTGGTGGCCGGG -> CAGGTTCTGGTGGCCGGGC
ACAGTCCAACAAATCTTGT -> CAGTCCAACAAATCTTGTG
ACAGTTCTCCGAGTTCCAA -> CAGTTCTCCGAGTTCCAAA
ACATCCGTATCCTCAAGGG -> CATCCGTATCCTCAAGGGA
ACATCTATGTCTGTTTTGG -> CATCTATGTCTGTTTTGGG
ACATGATTACGAACCTGTC -> CATGATTACGAACCTGTCG
ACATGTTTCGATTAAGTTC -> CATGTTTCGATTAAGTTCT
ACATTAAAGGTGGATGAGT -> CATTAAAGGTGGATGAGTT
ACATTCGTAGGGCCGCCAT -> CATTCGTAGGGCCGCCATA
ACATTGCAGTGATTCAATC -> CATTGCAGTGATTCAATCA
ACATTGTGACTGCTGCGCC -> CATTGTGACTGCTGCGCCC
ACCAATGCTCGCAGAGAAC -> CCAATGCTCGCAGAGAACT
ACCACACTCCCCGATCCAT -> CCACACTCCCCGATCCATT
ACCATATTCATAGCATCCT -> CCATATTCATAGCATCCTG
ACCATGCTCGGTTTTTCCT -> CCATGCTCGGTTTTTCCTC
ACCATGCTCTTTCTATGTT -> CCATGCTCTTTCTATGTTG
ACCCACAATAATGTTAGCG -> CCCACAATAATGTTAGCGC
ACCCCGGAAAGGCACTAAT -> CCCCGGAAAGGCACTAATA
ACCCGCGCGATCGTTTCCG -> CCCGCGCGATCGTTTCCGG
ACCCTCCCTGGAATCTTAC -> CCCTCCCTGGAATCTTACT
ACCCTGGTAGTGCCCCAAA -> CCCTGGTAGTGCCCCAAAG
ACCCTTATTCAGAGATGTG -> CCCTTATTCAGAGATGTGC
ACCGAATAACAAAGTATGG -> CCGAATAACAAAGTATGGT
ACCGAGGCATAGGGCTGGC -> CCGAGGCATAGGGCTGGCT
ACCGCACGCGAACATGTTT -> CCGCACGCGAACATGTTTC
ACCGCATCACGAGAAGGTG -> CCGCATCACGAGAAGGTGT
ACCGCGCGTGGATTTGTTA -> CCGCGCGTGGATTTGTTAG
ACCGTGCTTAAGAAATGTT -> CCGTGCTTAAGAAATGTTC
ACCGTTCCAGCGCTAATGC -> CCGTTCCAGCGCTAATGCG
ACCTACTTTCTTGTTTCGG -> CCTACTTTCTTGTTTCGGA
ACCTAGTTCCAACAAATCT -> CCTAGTTCCAACAAATCTT
ACCTCGCAGGGGGACCTTT -> CCTCGCAGGGGGACCTTTT
ACCTGTCGCATCGGCCGGA -> CCTGTCGCATCGGCCGGAC
ACCTGTTGCTATGATGGCA -> CCTGTTGCTATGATGGCAC
ACCTTAACTTGAGGACTTA -> CCTTAACTTGAGGACTTAC
ACCTTACTTGGAGGCACAA -> CCTTACTTGGAGGCACAAA
ACCTTATGCCTAGAAAGGC -> CCTTATGCCTAGAAAGGCG
ACCTTTTGTACGTTCCCGT -> CCTTTTGTACGTTCCCGTG
ACGAAAACACGCTGTAAGT -> CGAAAACACGCTGTAAGTC
ACGAACCTGTCGCATCGGC -> CGAACCTGTCGCATCGGCC
ACGAATATTTGGATATCGG -> CGAATATTTGGATATCGGT
ACGACGGTTAACAGTCCAA -> CGACGGTTAACAGTCCAAC
ACGAGAAGGTGTCTGAAGA -> CGAGAAGGTGTCTGAAGAA
ACGATTCGACCCACAATAA -> CGATTCGACCCACAATAAT
ACGCACTCCAATCTGGAGT -> CGCACTCCAATCTGGAGTA
ACGCAGTTTGGGAGCCTTC -> CGCAGTTTGGGAGCCTTCG
ACGCCCCTCGATGGTATAT -> CGCCCCTCGATGGTATATA
ACGCCGCATATTTCAATAG -> CGCCGCATATTTCAATAGA
ACGCCTACGGCTACTCCAA -> CGCCTACGGCTACTCCAAC
ACGCGAACATGTTTCGATT -> CGCGAACATGTTTCGATTA
ACGCGCTTTTGTAGCCGAA -> CGCGCTTTTGTAGCCGAAT
ACGCTGTAAGTCTCAGGTG -> CGCTGTAAGTCTCAGGTGA
ACGGACAGCTAGGGTCCAA -> CGGACAGCTAGGGTCCAAC
ACGGCCCCCTGTAGTGCTC -> CGGCCCCCTGTAGTGCTCA
ACGGCTACTCCAACAAATC -> CGGCTACTCCAACAAATCT
ACGGGTTAGGTTCTATCAA -> CGGGTTAGGTTCTATCAAT
ACGGTTAACAGTCCAACAA -> CGGTTAACAGTCCAACAAA
ACGGTTCTGAAATAAGAGA -> CGGTTCTGAAATAAGAGAC
ACGTAACGTCCACACGGCC -> CGTAACGTCCACACGGCCC
ACGTACTGCGAAACTCTTT -> CGTACTGCGAAACTCTTTA
ACGTCAACGCCCCTCGATG -> CGTCAACGCCCCTCGATGG
ACGTCCACACGGCCCCCTG -> CGTCCACACGGCCCCCTGT
ACGTGACACCTAGTTCCAA -> CGTGACACCTAGTTCCAAC
ACGTGATGGACAACTTATT -> CGTGATGGACAACTTATTG
ACGTGGGAACTAGTAGAAT -> CGTGGGAACTAGTAGAATT
ACGTGTAGGACACGAATAT -> CGTGTAGGACACGAATATT
ACGTTATGTAAAAGGAGAC -> CGTTATGTAAAAGGAGACC
ACGTTCCCCTGGCACCGTT -> CGTTCCCCTGGCACCGTTC
ACGTTCCCGTGTCGTATTC -> CGTTCCCGTGTCGTATTCA
ACGTTTTAGGCGATGTCAA -> CGTTTTAGGCGATGTCAAC
ACTAAAAAATATTTCCACC -> CTAAAAAATATTTCCACCC
ACTAACACGTTATGTAAAA -> CTAACACGTTATGTAAAAG
ACTAATACCGAGGCATAGG -> CTAATACCGAGGCATAGGG
ACTAATTTCCACTCGCGTG -> CTAATTTCCACTCGCGTGT
ACTACATTGTGACTGCTGC -> CTACATTGTGACTGCTGCG
ACTACTCCTTTGCCACAGC -> CTACTCCTTTGCCACAGCT
ACTAGACCGCGCGTGGATT -> CTAGACCGCGCGTGGATTT
ACTAGGATCCATACCGCAC -> CTAGGATCCATACCGCACG
ACTAGTAGAATTGTAAAGA -> CTAGTAGAATTGTAAAGAC
ACTATGAAACCTTATGCCT -> CTATGAAACCTTATGCCTA
ACTCAACAGTTCTCCGAGT -> CTCAACAGTTCTCCGAGTT
ACTCACGTGGGAACTAGTA -> CTCACGTGGGAACTAGTAG
ACTCCAACAAATCTTGTGA -> CTCCAACAAATCTTGTGAG
ACTCCAATCTGGAGTAATG -> CTCCAATCTGGAGTAATGC
ACTCCCCGATCCATTGCGT -> CTCCCCGATCCATTGCGTC
ACTCCTTTGCCACAGCTAG -> CTCCTTTGCCACAGCTAGT
ACTCGCGTGTCACGTTTTA -> CTCGCGTGTCACGTTTTAG
ACTCGCTGCCCCGACTAAT -> CTCGCTGCCCCGACTAATT
ACTCGGATCGACGCAGTTT -> CTCGGATCGACGCAGTTTG
ACTCTTTAATAGATCCGCG -> CTCTTTAATAGATCCGCGA
ACTCTTTACTTTTGTAGGC -> CTCTTTACTTTTGTAGGCC
ACTGCAGGCAACCCTGGTA -> CTGCAGGCAACCCTGGTAG
ACTGCGAAACTCTTTAATA -> CTGCGAAACTCTTTAATAG
ACTGCTGCGCCCTTAGCAG -> CTGCTGCGCCCTTAGCAGC
ACTGGCGGAACGCGCTTTT -> CTGGCGGAACGCGCTTTTG
ACTGGTAGTCCAGAGGTCT -> CTGGTAGTCCAGAGGTCTC
ACTGTCCAAAACATCTATG -> CTGTCCAAAACATCTATGT
ACTTACTTCTGGTCTTATG -> CTTACTTCTGGTCTTATGT
ACTTATCGTTCCACCCGCG -> CTTATCGTTCCACCCGCGC
ACTTATTGAGCCCGCGTCC -> CTTATTGAGCCCGCGTCCG
ACTTCTGGTCTTATGTTAG -> CTTCTGGTCTTATGTTAGC
ACTTGAGGACTTACTTCTG -> CTTGAGGACTTACTTCTGG
ACTTGGAGGCACAAATGCG -> CTTGGAGGCACAAATGCGC
ACTTGGTCAGTCCGGCTCT -> CTTGGTCAGTCCGGCTCTG
ACTTTCTTGTTTCGGACGT -> CTTTCTTGTTTCGGACGTA
ACTTTTGTAGGCCGCAGGT -> CTTTTGTAGGCCGCAGGTC
AGAAAGGCGTGAGTCGTGT -> GAAAGGCGTGAGTCGTGTC
AGAAATACTGCAGGCAACC -> GAAATACTGCAGGCAACCC
AGAAATCGCCTGTATCACG -> GAAATCGCCTGTATCACGC
AGAAATGTTCTAGGGGAAT -> GAAATGTTCTAGGGGAATT
AGAACAAGGCCGAGACAGA -> GAACAAGGCCGAGACAGAC
AGAACACTATGAAACCTTA -> GAACACTATGAAACCTTAT
AGAACTCGCTGCCCCGACT -> GAACTCGCTGCCCCGACTA
AGAAGGTGTCTGAAGAATT -> GAAGGTGTCTGAAGAATTC
AGAATGCGTTGCTAAGCGC -> GAATGCGTTGCTAAGCGCA
AGAATTAACATGATTACGA -> GAATTAACATGATTACGAA
AGAATTCGGGCGTTTTACG -> GAATTCGGGCGTTTTACGA
AGAATTGTAAAGACGCACT -> GAATTGTAAAGACGCACTC
AGACAGACCGCATCACGAG -> GACAGACCGCATCACGAGA
AGACAGGTTCTGGTGGCCG -> GACAGGTTCTGGTGGCCGG
AGACATCCGTATCCTCAAG -> GACATCCGTATCCTCAAGG
AGACCATGCTCTTTCTATG -> GACCATGCTCTTTCTATGT
AGACCGCATCACGAGAAGG -> GACCGCATCACGAGAAGGT
AGACCGCGCGTGGATTTGT -> GACCGCGCGTGGATTTGTT
AGACGCACTCCAATCTGGA -> GACGCACTCCAATCTGGAG
AGAGAACTCGCTGCCCCGA -> GAGAACTCGCTGCCCCGAC
AGAGACAGGTTCTGGTGGC -> GAGACAGGTTCTGGTGGCC
AGAGATGTGCTCACTCACG -> GAGATGTGCTCACTCACGT
AGAGCAGCCATATTCACCC -> GAGCAGCCATATTCACCCT
AGAGCCAAAGGCGCGCGGA -> GAGCCAAAGGCGCGCGGAT
AGAGGTCTCCAGGGCAAGA -> GAGGTCTCCAGGGCAAGAG
AGAGTCGTCTAGCTTCAAC -> GAGTCGTCTAGCTTCAACA
AGATCCCGTGCAGAGTCGT -> GATCCCGTGCAGAGTCGTC
AGATCCGCGAAAGAATGCG -> GATCCGCGAAAGAATGCGT
AGATGTGCTCACTCACGTG -> GATGTGCTCACTCACGTGG
AGATTGTTAATCGCCGGAT -> GATTGTTAATCGCCGGATA
AGCAGCCATATTCACCCTT -> GCAGCCATATTCACCCTTA
AGCAGCTGTGATGGCGGTA -> GCAGCTGTGATGGCGGTAT
AGCAGGCCACGTTCCCCTG -> GCAGGCCACGTTCCCCTGG
AGCATCCTGCCTTGAATCG -> GCATCCTGCCTTGAATCGC
AGCATGGGTTAGTTGGGGC -> GCATGGGTTAGTTGGGGCC
AGCCAAACCTACTTTCTTG -> GCCAAACCTACTTTCTTGT
AGCCAAAGGCGCGCGGATT -> GCCAAAGGCGCGCGGATTC
AGCCAGTTGTAGCTGTTCA -> GCCAGTTGTAGCTGTTCAT
AGCCATATTCACCCTTATT -> GCCATATTCACCCTTATTC
AGCCATTGTGAATTCGGGC -> GCCATTGTGAATTCGGGCG
AGCCCGCGTCCGACCTCGC -> GCCCGCGTCCGACCTCGCA
AGCCGAATTTTCGGTTCCT -> GCCGAATTTTCGGTTCCTC
AGCCTGGCACTAGGATCCA -> GCCTGGCACTAGGATCCAT
AGCCTTCGTTAGACATCCG -> GCCTTCGTTAGACATCCGT
AGCCTTGTCGGACTAACAC -> GCCTTGTCGGACTAACACG
AGCGAAACCAATGCTCGCA -> GCGAAACCAATGCTCGCAG
AGCGCACACCCTCCCTGGA -> GCGCACACCCTCCCTGGAA
AGCGCCCTTCAATTAGCTG -> GCGCCCTTCAATTAGCTGA
AGCGCTAATGCGCCGACCG -> GCGCTAATGCGCCGACCGT
AGCGGATTTGTCACTGGTA -> GCGGATTTGTCACTGGTAG
AGCTACCATGCTCGGTTTT -> GCTACCATGCTCGGTTTTT
AGCTAGGGTCCAACAAATC -> GCTAGGGTCCAACAAATCT
AGCTAGTAGGAATAGTTGT -> GCTAGTAGGAATAGTTGTC
AGCTGAGCAGGCCACGTTC -> GCTGAGCAGGCCACGTTCC
AGCTGTGATGGCGGTATGC -> GCTGTGATGGCGGTATGCC
AGCTGTTCATCCTAGAACA -> GCTGTTCATCCTAGAACAC
AGCTTCAACAGGGGCTTTT -> GCTTCAACAGGGGCTTTTA
AGCTTCCAACTGGCGGAAC -> GCTTCCAACTGGCGGAACG
AGCTTGTTGTTTTACCATA -> GCTTGTTGTTTTACCATAT
AGGAATAGTTGTCGTTTAA -> GGAATAGTTGTCGTTTAAA
AGGACACGAATATTTGGAT -> GGACACGAATATTTGGATA
AGGACGATTCGACCCACAA -> GGACGATTCGACCCACAAT
AGGACTTACTTCTGGTCTT -> GGACTTACTTCTGGTCTTA
AGGAGACCATGCTCTTTCT -> GGAGACCATGCTCTTTCTA
AGGATCAGGACGATTCGAC -> GGATCAGGACGATTCGACC
AGGATCCATACCGCACGCG -> GGATCCATACCGCACGCGA
AGGCAACCCTGGTAGTGCC -> GGCAACCCTGGTAGTGCCC
AGGCACAAATGCGCCACGT -> GGCACAAATGCGCCACGTG
AGGCACTAATACCGAGGCA -> GGCACTAATACCGAGGCAT
AGGCATAGGGCTGGCTGGA -> GGCATAGGGCTGGCTGGAC
AGGCCACGTTCCCCTGGCA -> GGCCACGTTCCCCTGGCAC
AGGCCGAGACAGACCGCAT -> GGCCGAGACAGACCGCATC
AGGCCGCAGGTCGCCGGAC -> GGCCGCAGGTCGCCGGACT
AGGCGATGTCAACATTGCA -> GGCGATGTCAACATTGCAG
AGGCGCGCGGATTCCGTTC -> GGCGCGCGGATTCCGTTCC
AGGCGGGGGATTCTCCCGC -> GGCGGGGGATTCTCCCGCC
AGGCGTGAGTCGTGTCCCG -> GGCGTGAGTCGTGTCCCGT
AGGGAAGTACCGAATAACA -> GGGAAGTACCGAATAACAA
AGGGCAAGAGCCAAAGGCG -> GGGCAAGAGCCAAAGGCGC
AGGGCCGCCATATACGTAC -> GGGCCGCCATATACGTACT
AGGGCTGGCTGGACGTGAT -> GGGCTGGCTGGACGTGATG
AGGGGAATTCGGGCGTTTT -> GGGGAATTCGGGCGTTTTA
AGGGGCTTTTACCTTAACT -> GGGGCTTTTACCTTAACTT
AGGGGGACCTTTTGTACGT -> GGGGGACCTTTTGTACGTT
AGGGTCCAACAAATCTTGT -> GGGTCCAACAAATCTTGTG
AGGTCGCCGGACTGTCCAA -> GGTCGCCGGACTGTCCAAA
AGGTCTCCAGGGCAAGAGC -> GGTCTCCAGGGCAAGAGCC
AGGTGATAGATTGTTAATC -> GGTGATAGATTGTTAATCG
AGGTGCCAAGTAGCTTCCA -> GGTGCCAAGTAGCTTCCAA
AGGTGGATGAGTTCGGGCT -> GGTGGATGAGTTCGGGCTT
AGGTGTCTGAAGAATTCGG -> GGTGTCTGAAGAATTCGGG
AGGTTCTATCAATGTCGTC -> GGTTCTATCAATGTCGTCT
AGGTTCTGGTGGCCGGGCG -> GGTTCTGGTGGCCGGGCGG
AGTACCGAATAACAAAGTA -> GTACCGAATAACAAAGTAT
AGTACTTATCGTTCCACCC -> GTACTTATCGTTCCACCCG
AGTAGAATTGTAAAGACGC -> GTAGAATTGTAAAGACGCA
AGTAGCTTCCAACTGGCGG -> GTAGCTTCCAACTGGCGGA
AGTAGGAATAGTTGTCGTT -> GTAGGAATAGTTGTCGTTT
AGTATGGTCTTGTAGTACT -> GTATGGTCTTGTAGTACTT
AGTCCAACAAATCTTGTGA -> GTCCAACAAATCTTGTGAG
AGTCCAGAGGTCTCCAGGG -> GTCCAGAGGTCTCCAGGGC
AGTCCGGCTCTGGAGTGTA -> GTCCGGCTCTGGAGTGTAC
AGTCGGTCTTTTGCACAGG -> GTCGGTCTTTTGCACAGGA
AGTCGTCTAGCTTCAACAG -> GTCGTCTAGCTTCAACAGG
AGTCGTGTCCCGTCTCGGA -> GTCGTGTCCCGTCTCGGAA
AGTCTCAGGTGATAGATTG -> GTCTCAGGTGATAGATTGT
AGTGATTCAATCATTGGTA -> GTGATTCAATCATTGGTAC
AGTGCCCCAAAGCCAAACC -> GTGCCCCAAAGCCAAACCT
AGTGCTCACTCAACAGTTC -> GTGCTCACTCAACAGTTCT
AGTGTACGGGTTAGGTTCT -> GTGTACGGGTTAGGTTCTA
AGTTCCAAACGTCAACGCC -> GTTCCAAACGTCAACGCCC
AGTTCCAACAAATCTTGTG -> GTTCCAACAAATCTTGTGA
AGTTCGGGCTTGACGAAAA -> GTTCGGGCTTGACGAAAAC
AGTTCTCCGAGTTCCAAAC -> GTTCTCCGAGTTCCAAACG
AGTTCTGAAAAATGCGTGT -> GTTCTGAAAAATGCGTGTC
AGTTGGGGCCGAGAGCAGC -> GTTGGGGCCGAGAGCAGCC
AGTTGTAGCTGTTCATCCT -> GTTGTAGCTGTTCATCCTA
AGTTGTCGTTTAAACGGTT -> GTTGTCGTTTAAACGGTTC
AGTTGTCTGTGCCCTCTAG -> GTTGTCTGTGCCCTCTAGA
AGTTTGGGAGCCTTCGTTA -> GTTTGGGAGCCTTCGTTAG
AGTTTTCCCCACATTCGTA -> GTTTTCCCCACATTCGTAG
ATAACAAAGTATGGTCTTG -> TAACAAAGTATGGTCTTGT
ATAAGAGACAGGTTCTGGT -> TAAGAGACAGGTTCTGGTG
ATAATGTTAGCGCCCTTCA -> TAATGTTAGCGCCCTTCAA
ATACCGAGGCATAGGGCTG -> TACCGAGGCATAGGGCTGG
ATACCGCACGCGAACATGT -> TACCGCACGCGAACATGTT
ATACGTACTGCGAAACTCT -> TACGTACTGCGAAACTCTT
ATACTGCAGGCAACCCTGG -> TACTGCAGGCAACCCTGGT
ATAGAAATACTGCAGGCAA -> TAGAAATACTGCAGGCAAC
ATAGAATTAACATGATTAC -> TAGAATTAACATGATTACG
ATAGATCCGCGAAAGAATG -> TAGATCCGCGAAAGAATGC
ATAGATTGTTAATCGCCGG -> TAGATTGTTAATCGCCGGA
ATAGCATCCTGCCTTGAAT -> TAGCATCCTGCCTTGAATC
ATAGCCATTGTGAATTCGG -> TAGCCATTGTGAATTCGGG
ATAGCCTTGTCGGACTAAC -> TAGCCTTGTCGGACTAACA
ATAGGGCTGGCTGGACGTG -> TAGGGCTGGCTGGACGTGA
ATAGTTGTCGTTTAAACGG -> TAGTTGTCGTTTAAACGGT
ATATACGTACTGCGAAACT -> TATACGTACTGCGAAACTC
ATATAGAATTAACATGATT -> TATAGAATTAACATGATTA
ATATCGGTTGAGGCGGGGG -> TATCGGTTGAGGCGGGGGA
ATATTCAAGAACAAGGCCG -> TATTCAAGAACAAGGCCGA
ATATTCACCCTTATTCAGA -> TATTCACCCTTATTCAGAG
ATATTCATAGCATCCTGCC -> TATTCATAGCATCCTGCCT
ATATTGGATCGATAGCCTT -> TATTGGATCGATAGCCTTG
ATATTTCAATAGAAATACT -> TATTTCAATAGAAATACTG
ATATTTCCACCCCGGAAAG -> TATTTCCACCCCGGAAAGG
ATATTTGGATATCGGTTGA -> TATTTGGATATCGGTTGAG
ATCAATGTCGTCTCTGAAA -> TCAATGTCGTCTCTGAAAA
ATCACGAGAAGGTGTCTGA -> TCACGAGAAGGTGTCTGAA
ATCACGCCGCATATTTCAA -> TCACGCCGCATATTTCAAT
ATCAGGACGATTCGACCCA -> TCAGGACGATTCGACCCAC
ATCATTGGTACTTGGTCAG -> TCATTGGTACTTGGTCAGT
ATCCATACCGCACGCGAAC -> TCCATACCGCACGCGAACA
ATCCATTGCGTCCTCTGCT -> TCCATTGCGTCCTCTGCTT
ATCCCGTGCAGAGTCGTCT -> TCCCGTGCAGAGTCGTCTA
ATCCGCGAAAGAATGCGTT -> TCCGCGAAAGAATGCGTTG
ATCCGTATCCTCAAGGGAA -> TCCGTATCCTCAAGGGAAG
ATCCTAGAACACTATGAAA -> TCCTAGAACACTATGAAAC
ATCCTCAAGGGAAGTACCG -> TCCTCAAGGGAAGTACCGA
ATCCTGCCTTGAATCGCAC -> TCCTGCCTTGAATCGCACA
ATCGACGCAGTTTGGGAGC -> TCGACGCAGTTTGGGAGCC
ATCGATAGCCTTGTCGGAC -> TCGATAGCCTTGTCGGACT
ATCGCACATTAAAGGTGGA -> TCGCACATTAAAGGTGGAT
ATCGCCGGATATTGGATCG -> TCGCCGGATATTGGATCGA
ATCGCCTGTATCACGCCGC -> TCGCCTGTATCACGCCGCA
ATCGGCCGGACAGCCTGGC -> TCGGCCGGACAGCCTGGCA
ATCGGTTGAGGCGGGGGAT -> TCGGTTGAGGCGGGGGATT
ATCGTTCCACCCGCGCGAT -> TCGTTCCACCCGCGCGATC
ATCGTTTCCGGTAGTTTTC -> TCGTTTCCGGTAGTTTTCC
ATCTAACTACATTGTGACT -> TCTAACTACATTGTGACTG
ATCTATGTCTGTTTTGGGT -> TCTATGTCTGTTTTGGGTG
ATCTTACTCTTTACTTTTG -> TCTTACTCTTTACTTTTGT
ATCTTGTGAGCATGGGTTA -> TCTTGTGAGCATGGGTTAG
ATCTTGTGAGCCAGTTGTA -> TCTTGTGAGCCAGTTGTAG
ATCTTGTGAGCGGATTTGT -> TCTTGTGAGCGGATTTGTC
ATCTTGTGAGCTTGTTGTT -> TCTTGTGAGCTTGTTGTTT
ATGAAACCTTATGCCTAGA -> TGAAACCTTATGCCTAGAA
ATGACCTGTTGCTATGATG -> TGACCTGTTGCTATGATGG
ATGAGTCGGTCTTTTGCAC -> TGAGTCGGTCTTTTGCACA
ATGAGTTCGGGCTTGACGA -> TGAGTTCGGGCTTGACGAA
ATGATGGCACACTACTCCT -> TGATGGCACACTACTCCTT
ATGATTACGAACCTGTCGC -> TGATTACGAACCTGTCGCA
ATGCCGGAACCACACTCCC -> TGCCGGAACCACACTCCCC
ATGCCTAGAAAGGCGTGAG -> TGCCTAGAAAGGCGTGAGT
ATGCGCCACGTGTAGGACA -> TGCGCCACGTGTAGGACAC
ATGCGCCGACCGTGCTTAA -> TGCGCCGACCGTGCTTAAG
ATGCGTGTCTCGAATTCGG -> TGCGTGTCTCGAATTCGGG
ATGCGTTGCTAAGCGCACA -> TGCGTTGCTAAGCGCACAC
ATGCTCGCAGAGAACTCGC -> TGCTCGCAGAGAACTCGCT
ATGCTCGGTTTTTCCTCGC -> TGCTCGGTTTTTCCTCGCG
ATGCTCTTTCTATGTTGCC -> TGCTCTTTCTATGTTGCCC
ATGGACAACTTATTGAGCC -> TGGACAACTTATTGAGCCC
ATGGCACACTACTCCTTTG -> TGGCACACTACTCCTTTGC
ATGGCGGTATGCCGGAACC -> TGGCGGTATGCCGGAACCA
ATGGGTTAGTTGGGGCCGA -> TGGGTTAGTTGGGGCCGAG
ATGGTATATAGAATTAACA -> TGGTATATAGAATTAACAT
ATGGTCTTGTAGTACTTAT -> TGGTCTTGTAGTACTTATC
ATGTAAAAGGAGACCATGC -> TGTAAAAGGAGACCATGCT
ATGTCAACATTGCAGTGAT -> TGTCAACATTGCAGTGATT
ATGTCGTCTCTGAAAACCT -> TGTCGTCTCTGAAAACCTT
ATGTCTGTTTTGGGTGAAA -> TGTCTGTTTTGGGTGAAAA
ATGTGCTCACTCACGTGGG -> TGTGCTCACTCACGTGGGA
ATGTTAGCGAAACCAATGC -> TGTTAGCGAAACCAATGCT
ATGTTAGCGCCCTTCAATT -> TGTTAGCGCCCTTCAATTA
ATGTTCTAGGGGAATTCGG -> TGTTCTAGGGGAATTCGGG
ATGTTGCCCTCAGCTACCA -> TGTTGCCCTCAGCTACCAT
ATGTTTCGATTAAGTTCTG -> TGTTTCGATTAAGTTCTGA
ATTAAAGGTGGATGAGTTC -> TTAAAGGTGGATGAGTTCG
ATTAACATGATTACGAACC -> TTAACATGATTACGAACCT
ATTAAGTTCTGAAAAATGC -> TTAAGTTCTGAAAAATGCG
ATTACGAACCTGTCGCATC -> TTACGAACCTGTCGCATCG
ATTAGCTGAGCAGGCCACG -> TTAGCTGAGCAGGCCACGT
ATTCAAGAACAAGGCCGAG -> TTCAAGAACAAGGCCGAGA
ATTCAATCATTGGTACTTG -> TTCAATCATTGGTACTTGG
ATTCACCCTTATTCAGAGA -> TTCACCCTTATTCAGAGAT
ATTCAGAGATGTGCTCACT -> TTCAGAGATGTGCTCACTC
ATTCATAGCATCCTGCCTT -> TTCATAGCATCCTGCCTTG
ATTCATCTAACTACATTGT -> TTCATCTAACTACATTGTG
ATTCCGTTCCAGGTGCCAA -> TTCCGTTCCAGGTGCCAAG
ATTCGACCCACAATAATGT -> TTCGACCCACAATAATGTT
ATTCGGGCGTTTTACGACG -> TTCGGGCGTTTTACGACGG
ATTCGGGCGTTTTACGCCT -> TTCGGGCGTTTTACGCCTA
ATTCGGGCGTTTTACGGAC -> TTCGGGCGTTTTACGGACA
ATTCGGGCGTTTTACGTGA -> TTCGGGCGTTTTACGTGAC
ATTCGTAGGGCCGCCATAT -> TTCGTAGGGCCGCCATATA
ATTCTCCCGCCCACTAGAC -> TTCTCCCGCCCACTAGACC
ATTGAGCCCGCGTCCGACC -> TTGAGCCCGCGTCCGACCT
ATTGCAGTGATTCAATCAT -> TTGCAGTGATTCAATCATT
ATTGCGTCCTCTGCTTTGC -> TTGCGTCCTCTGCTTTGCT
ATTGGATCGATAGCCTTGT -> TTGGATCGATAGCCTTGTC
ATTGGTACTTGGTCAGTCC -> TTGGTACTTGGTCAGTCCG
ATTGTAAAGACGCACTCCA -> TTGTAAAGACGCACTCCAA
ATTGTGAATTCGGGCGTTT -> TTGTGAATTCGGGCGTTTT
ATTGTGACTGCTGCGCCCT -> TTGTGACTGCTGCGCCCTT
ATTGTTAATCGCCGGATAT -> TTGTTAATCGCCGGATATT
ATTTCAATAGAAATACTGC -> TTTCAATAGAAATACTGCA
ATTTCCACCCCGGAAAGGC -> TTTCCACCCCGGAAAGGCA
ATTTCCACTCGCGTGTCAC -> TTTCCACTCGCGTGTCACG
ATTTCTTCATGAGTCGGTC -> TTTCTTCATGAGTCGGTCT
ATTTGGATATCGGTTGAGG -> TTTGGATATCGGTTGAGGC
ATTTGTCACTGGTAGTCCA -> TTTGTCACTGGTAGTCCAG
ATTTGTTAGAAATCGCCTG -> TTTGTTAGAAATCGCCTGT
ATTTTCGGTTCCTCCTACT -> TTTTCGGTTCCTCCTACTC
CAAAACATCTATGTCTGTT -> AAAACATCTATGTCTGTTT
CAAACCTACTTTCTTGTTT -> AAACCTACTTTCTTGTTTC
CAAACGTCAACGCCCCTCG -> AAACGTCAACGCCCCTCGA
CAAAGCCAAACCTACTTTC -> AAAGCCAAACCTACTTTCT
CAAAGGCGCGCGGATTCCG -> AAAGGCGCGCGGATTCCGT
CAAAGTATGGTCTTGTAGT -> AAAGTATGGTCTTGTAGTA
CAAATCTTGTGAGCATGGG -> AAATCTTGTGAGCATGGGT
CAAATCTTGTGAGCCAGTT -> AAATCTTGTGAGCCAGTTG
CAAATCTTGTGAGCGGATT -> AAATCTTGTGAGCGGATTT
CAAATCTTGTGAGCTTGTT -> AAATCTTGTGAGCTTGTTG
CAAATGCGCCACGTGTAGG -> AAATGCGCCACGTGTAGGA
CAACAAATCTTGTGAGCAT -> AACAAATCTTGTGAGCATG
CAACAAATCTTGTGAGCCA -> AACAAATCTTGTGAGCCAG
CAACAAATCTTGTGAGCGG -> AACAAATCTTGTGAGCGGA
CAACAAATCTTGTGAGCTT -> AACAAATCTTGTGAGCTTG
CAACAGGGGCTTTTACCTT -> AACAGGGGCTTTTACCTTA
CAACAGTTCTCCGAGTTCC -> AACAGTTCTCCGAGTTCCA
CAACATTGCAGTGATTCAA -> AACATTGCAGTGATTCAAT
CAACCCTGGTAGTGCCCCA -> AACCCTGGTAGTGCCCCAA
CAACGCCCCTCGATGGTAT -> AACGCCCCTCGATGGTATA
CAACTGGCGGAACGCGCTT -> AACTGGCGGAACGCGCTTT
CAACTTATTGAGCCCGCGT -> AACTTATTGAGCCCGCGTC
CAAGAACAAGGCCGAGACA -> AAGAACAAGGCCGAGACAG
CAAGAGCCAAAGGCGCGCG -> AAGAGCCAAAGGCGCGCGG
CAAGGCCGAGACAGACCGC -> AAGGCCGAGACAGACCGCA
CAAGGGAAGTACCGAATAA -> AAGGGAAGTACCGAATAAC
CAAGTAGCTTCCAACTGGC -> AAGTAGCTTCCAACTGGCG
CAATAATGTTAGCGCCCTT -> AATAATGTTAGCGCCCTTC
CAATAGAAATACTGCAGGC -> AATAGAAATACTGCAGGCA
CAATCATTGGTACTTGGTC -> AATCATTGGTACTTGGTCA
CAATCTGGAGTAATGCAAG -> AATCTGGAGTAATGCAAGC
CAATGCTCGCAGAGAACTC -> AATGCTCGCAGAGAACTCG
CAATGTCGTCTCTGAAAAC -> AATGTCGTCTCTGAAAACC
CAATTAGCTGAGCAGGCCA -> AATTAGCTGAGCAGGCCAC
CACAAATGCGCCACGTGTA -> ACAAATGCGCCACGTGTAG
CACAATAATGTTAGCGCCC -> ACAATAATGTTAGCGCCCT
CACACCCTCCCTGGAATCT -> ACACCCTCCCTGGAATCTT
CACACGGCCCCCTGTAGTG -> ACACGGCCCCCTGTAGTGC
CACACTACTCCTTTGCCAC -> ACACTACTCCTTTGCCACA
CACACTCCCCGATCCATTG -> ACACTCCCCGATCCATTGC
CACAGCTAGTAGGAATAGT -> ACAGCTAGTAGGAATAGTT
CACAGGATCAGGACGATTC -> ACAGGATCAGGACGATTCG
CACATTAAAGGTGGATGAG -> ACATTAAAGGTGGATGAGT
CACATTCGTAGGGCCGCCA -> ACATTCGTAGGGCCGCCAT
CACCCCGGAAAGGCACTAA -> ACCCCGGAAAGGCACTAAT
CACCCGCGCGATCGTTTCC -> ACCCGCGCGATCGTTTCCG
CACCCTCCCTGGAATCTTA -> ACCCTCCCTGGAATCTTAC
CACCCTTATTCAGAGATGT -> ACCCTTATTCAGAGATGTG
CACCGTTCCAGCGCTAATG -> ACCGTTCCAGCGCTAATGC
CACCTAGTTCCAACAAATC -> ACCTAGTTCCAACAAATCT
CACGAATATTTGGATATCG -> ACGAATATTTGGATATCGG
CACGAGAAGGTGTCTGAAG -> ACGAGAAGGTGTCTGAAGA
CACGCCGCATATTTCAATA -> ACGCCGCATATTTCAATAG
CACGCGAACATGTTTCGAT -> ACGCGAACATGTTTCGATT
CACGCTGTAAGTCTCAGGT -> ACGCTGTAAGTCTCAGGTG
CACGGCCCCCTGTAGTGCT -> ACGGCCCCCTGTAGTGCTC
CACGTGGGAACTAGTAGAA -> ACGTGGGAACTAGTAGAAT
CACGTGTAGGACACGAATA -> ACGTGTAGGACACGAATAT
CACGTTATGTAAAAGGAGA -> ACGTTATGTAAAAGGAGAC
CACGTTCCCCTGGCACCGT -> ACGTTCCCCTGGCACCGTT
CACGTTTTAGGCGATGTCA -> ACGTTTTAGGCGATGTCAA
CACTAATACCGAGGCATAG -> ACTAATACCGAGGCATAGG
CACTACTCCTTTGCCACAG -> ACTACTCCTTTGCCACAGC
CACTAGACCGCGCGTGGAT -> ACTAGACCGCGCGTGGATT
CACTAGGATCCATACCGCA -> ACTAGGATCCATACCGCAC
CACTATGAAACCTTATGCC -> ACTATGAAACCTTATGCCT
CACTCAACAGTTCTCCGAG -> ACTCAACAGTTCTCCGAGT
CACTCACGTGGGAACTAGT -> ACTCACGTGGGAACTAGTA
CACTCCAATCTGGAGTAAT -> ACTCCAATCTGGAGTAATG
CACTCCCCGATCCATTGCG -> ACTCCCCGATCCATTGCGT
CACTCGCGTGTCACGTTTT -> ACTCGCGTGTCACGTTTTA
CACTGGTAGTCCAGAGGTC -> ACTGGTAGTCCAGAGGTCT
CAGACCGCATCACGAGAAG -> AGACCGCATCACGAGAAGG
CAGAGAACTCGCTGCCCCG -> AGAGAACTCGCTGCCCCGA
CAGAGATGTGCTCACTCAC -> AGAGATGTGCTCACTCACG
CAGAGGTCTCCAGGGCAAG -> AGAGGTCTCCAGGGCAAGA
CAGAGTCGTCTAGCTTCAA -> AGAGTCGTCTAGCTTCAAC
CAGCCATATTCACCCTTAT -> AGCCATATTCACCCTTATT
CAGCCTGGCACTAGGATCC -> AGCCTGGCACTAGGATCCA
CAGCGCTAATGCGCCGACC -> AGCGCTAATGCGCCGACCG
CAGCTACCATGCTCGGTTT -> AGCTACCATGCTCGGTTTT
CAGCTAGGGTCCAACAAAT -> AGCTAGGGTCCAACAAATC
CAGCTAGTAGGAATAGTTG -> AGCTAGTAGGAATAGTTGT
CAGCTGTGATGGCGGTATG -> AGCTGTGATGGCGGTATGC
CAGGACGATTCGACCCACA -> AGGACGATTCGACCCACAA
CAGGATCAGGACGATTCGA -> AGGATCAGGACGATTCGAC
CAGGCAACCCTGGTAGTGC -> AGGCAACCCTGGTAGTGCC
CAGGCCACGTTCCCCTGGC -> AGGCCACGTTCCCCTGGCA
CAGGGCAAGAGCCAAAGGC -> AGGGCAAGAGCCAAAGGCG
CAGGGGCTTTTACCTTAAC -> AGGGGCTTTTACCTTAACT
CAGGGGGACCTTTTGTACG -> AGGGGGACCTTTTGTACGT
CAGGTCGCCGGACTGTCCA -> AGGTCGCCGGACTGTCCAA
CAGGTGATAGATTGTTAAT -> AGGTGATAGATTGTTAATC
CAGGTGCCAAGTAGCTTCC -> AGGTGCCAAGTAGCTTCCA
CAGGTTCTGGTGGCCGGGC -> AGGTTCTGGTGGCCGGGCG
CAGTCCAACAAATCTTGTG -> AGTCCAACAAATCTTGTGA
CAGTCCGGCTCTGGAGTGT -> AGTCCGGCTCTGGAGTGTA
CAGTGATTCAATCATTGGT -> AGTGATTCAATCATTGGTA
CAGTTCTCCGAGTTCCAAA -> AGTTCTCCGAGTTCCAAAC
CAGTTGTAGCTGTTCATCC -> AGTTGTAGCTGTTCATCCT
CAGTTGTCTGTGCCCTCTA -> AGTTGTCTGTGCCCTCTAG
CAGTTTGGGAGCCTTCGTT -> AGTTTGGGAGCCTTCGTTA
CATACCGCACGCGAACATG -> ATACCGCACGCGAACATGT
CATAGCATCCTGCCTTGAA -> ATAGCATCCTGCCTTGAAT
CATAGGGCTGGCTGGACGT -> ATAGGGCTGGCTGGACGTG
CATATACGTACTGCGAAAC -> ATATACGTACTGCGAAACT
CATATTCAAGAACAAGGCC -> ATATTCAAGAACAAGGCCG
CATATTCACCCTTATTCAG -> ATATTCACCCTTATTCAGA
CATATTCATAGCATCCTGC -> ATATTCATAGCATCCTGCC
CATATTTCAATAGAAATAC -> ATATTTCAATAGAAATACT
CATCACGAGAAGGTGTCTG -> ATCACGAGAAGGTGTCTGA
CATCCGTATCCTCAAGGGA -> ATCCGTATCCTCAAGGGAA
CATCCTAGAACACTATGAA -> ATCCTAGAACACTATGAAA
CATCCTGCCTTGAATCGCA -> ATCCTGCCTTGAATCGCAC
CATCGGCCGGACAGCCTGG -> ATCGGCCGGACAGCCTGGC
CATCTAACTACATTGTGAC -> ATCTAACTACATTGTGACT
CATCTATGTCTGTTTTGGG -> ATCTATGTCTGTTTTGGGT
CATGACCTGTTGCTATGAT -> ATGACCTGTTGCTATGATG
CATGAGTCGGTCTTTTGCA -> ATGAGTCGGTCTTTTGCAC
CATGATTACGAACCTGTCG -> ATGATTACGAACCTGTCGC
CATGCTCGGTTTTTCCTCG -> ATGCTCGGTTTTTCCTCGC
CATGCTCTTTCTATGTTGC -> ATGCTCTTTCTATGTTGCC
CATGGGTTAGTTGGGGCCG -> ATGGGTTAGTTGGGGCCGA
CATGTTTCGATTAAGTTCT -> ATGTTTCGATTAAGTTCTG
CATTAAAGGTGGATGAGTT -> ATTAAAGGTGGATGAGTTC
CATTCGTAGGGCCGCCATA -> ATTCGTAGGGCCGCCATAT
CATTGCAGTGATTCAATCA -> ATTGCAGTGATTCAATCAT
CATTGCGTCCTCTGCTTTG -> ATTGCGTCCTCTGCTTTGC
CATTGGTACTTGGTCAGTC -> ATTGGTACTTGGTCAGTCC
CATTGTGAATTCGGGCGTT -> ATTGTGAATTCGGGCGTTT
CATTGTGACTGCTGCGCCC -> ATTGTGACTGCTGCGCCCT
CCAAAACATCTATGTCTGT -> CAAAACATCTATGTCTGTT
CCAAACCTACTTTCTTGTT -> CAAACCTACTTTCTTGTTT
CCAAACGTCAACGCCCCTC -> CAAACGTCAACGCCCCTCG
CCAAAGCCAAACCTACTTT -> CAAAGCCAAACCTACTTTC
CCAAAGGCGCGCGGATTCC -> CAAAGGCGCGCGGATTCCG
CCAACAAATCTTGTGAGCA -> CAACAAATCTTGTGAGCAT
CCAACAAATCTTGTGAGCC -> CAACAAATCTTGTGAGCCA
CCAACAAATCTTGTGAGCG -> CAACAAATCTTGTGAGCGG
CCAACAAATCTTGTGAGCT -> CAACAAATCTTGTGAGCTT
CCAACTGGCGGAACGCGCT -> CAACTGGCGGAACGCGCTT
CCAAGTAGCTTCCAACTGG -> CAAGTAGCTTCCAACTGGC
CCAATCTGGAGTAATGCAA -> CAATCTGGAGTAATGCAAG
CCAATGCTCGCAGAGAACT -> CAATGCTCGCAGAGAACTC
CCACAATAATGTTAGCGCC -> CACAATAATGTTAGCGCCC
CCACACGGCCCCCTGTAGT -> CACACGGCCCCCTGTAGTG
CCACACTCCCCGATCCATT -> CACACTCCCCGATCCATTG
CCACAGCTAGTAGGAATAG -> CACAGCTAGTAGGAATAGT
CCACATTCGTAGGGCCGCC -> CACATTCGTAGGGCCGCCA
CCACCCCGGAAAGGCACTA -> CACCCCGGAAAGGCACTAA
CCACCCGCGCGATCGTTTC -> CACCCGCGCGATCGTTTCC
CCACGTGTAGGACACGAAT -> CACGTGTAGGACACGAATA
CCACGTTCCCCTGGCACCG -> CACGTTCCCCTGGCACCGT
CCACTAGACCGCGCGTGGA -> CACTAGACCGCGCGTGGAT
CCACTCGCGTGTCACGTTT -> CACTCGCGTGTCACGTTTT
CCAGAGGTCTCCAGGGCAA -> CAGAGGTCTCCAGGGCAAG
CCAGCGCTAATGCGCCGAC -> CAGCGCTAATGCGCCGACC
CCAGGGCAAGAGCCAAAGG -> CAGGGCAAGAGCCAAAGGC
CCAGGTGCCAAGTAGCTTC -> CAGGTGCCAAGTAGCTTCC
CCAGTTGTAGCTGTTCATC -> CAGTTGTAGCTGTTCATCC
CCATACCGCACGCGAACAT -> CATACCGCACGCGAACATG
CCATATACGTACTGCGAAA -> CATATACGTACTGCGAAAC
CCATATTCACCCTTATTCA -> CATATTCACCCTTATTCAG
CCATATTCATAGCATCCTG -> CATATTCATAGCATCCTGC
CCATGACCTGTTGCTATGA -> CATGACCTGTTGCTATGAT
CCATGCTCGGTTTTTCCTC -> CATGCTCGGTTTTTCCTCG
CCATGCTCTTTCTATGTTG -> CATGCTCTTTCTATGTTGC
CCATTGCGTCCTCTGCTTT -> CATTGCGTCCTCTGCTTTG
CCATTGTGAATTCGGGCGT -> CATTGTGAATTCGGGCGTT
CCCAAAGCCAAACCTACTT -> CCAAAGCCAAACCTACTTT
CCCACAATAATGTTAGCGC -> CCACAATAATGTTAGCGCC
CCCACATTCGTAGGGCCGC -> CCACATTCGTAGGGCCGCC
CCCACTAGACCGCGCGTGG -> CCACTAGACCGCGCGTGGA
CCCCAAAGCCAAACCTACT -> CCCAAAGCCAAACCTACTT
CCCCACATTCGTAGGGCCG -> CCCACATTCGTAGGGCCGC
CCCCCTGTAGTGCTCACTC -> CCCCTGTAGTGCTCACTCA
CCCCGACTAATTTCCACTC -> CCCGACTAATTTCCACTCG
CCCCGATCCATTGCGTCCT -> CCCGATCCATTGCGTCCTC
CCCCGGAAAGGCACTAATA -> CCCGGAAAGGCACTAATAC
CCCCTCGATGGTATATAGA -> CCCTCGATGGTATATAGAA
CCCCTGGCACCGTTCCAGC -> CCCTGGCACCGTTCCAGCG
CCCCTGTAGTGCTCACTCA -> CCCTGTAGTGCTCACTCAA
CCCGACTAATTTCCACTCG -> CCGACTAATTTCCACTCGC
CCCGATCCATTGCGTCCTC -> CCGATCCATTGCGTCCTCT
CCCGCCCACTAGACCGCGC -> CCGCCCACTAGACCGCGCG
CCCGCGCGATCGTTTCCGG -> CCGCGCGATCGTTTCCGGT
CCCGCGTCCGACCTCGCAG -> CCGCGTCCGACCTCGCAGG
CCCGGAAAGGCACTAATAC -> CCGGAAAGGCACTAATACC
CCCGTCTCGGAAATTTCTT -> CCGTCTCGGAAATTTCTTC
CCCGTGCAGAGTCGTCTAG -> CCGTGCAGAGTCGTCTAGC
CCCGTGTCGTATTCATCTA -> CCGTGTCGTATTCATCTAA
CCCTCAGCTACCATGCTCG -> CCTCAGCTACCATGCTCGG
CCCTCCCTGGAATCTTACT -> CCTCCCTGGAATCTTACTC
CCCTCGATGGTATATAGAA -> CCTCGATGGTATATAGAAT
CCCTCTAGATCCCGTGCAG -> CCTCTAGATCCCGTGCAGA
CCCTGGAATCTTACTCTTT -> CCTGGAATCTTACTCTTTA
CCCTGGCACCGTTCCAGCG -> CCTGGCACCGTTCCAGCGC
CCCTGGTAGTGCCCCAAAG -> CCTGGTAGTGCCCCAAAGC
CCCTGTAGTGCTCACTCAA -> CCTGTAGTGCTCACTCAAC
CCCTTAGCAGCTGTGATGG -> CCTTAGCAGCTGTGATGGC
CCCTTATTCAGAGATGTGC -> CCTTATTCAGAGATGTGCT
CCCTTCAATTAGCTGAGCA -> CCTTCAATTAGCTGAGCAG
CCGAATAACAAAGTATGGT -> CGAATAACAAAGTATGGTC
CCGAATTTTCGGTTCCTCC -> CGAATTTTCGGTTCCTCCT
CCGACCGTGCTTAAGAAAT -> CGACCGTGCTTAAGAAATG
CCGACCTCGCAGGGGGACC -> CGACCTCGCAGGGGGACCT
CCGACTAATTTCCACTCGC -> CGACTAATTTCCACTCGCG
CCGAGACAGACCGCATCAC -> CGAGACAGACCGCATCACG
CCGAGAGCAGCCATATTCA -> CGAGAGCAGCCATATTCAC
CCGAGGCATAGGGCTGGCT -> CGAGGCATAGGGCTGGCTG
CCGAGTTCCAAACGTCAAC -> CGAGTTCCAAACGTCAACG
CCGATCCATTGCGTCCTCT -> CGATCCATTGCGTCCTCTG
CCGCACGCGAACATGTTTC -> CGCACGCGAACATGTTTCG
CCGCAGGTCGCCGGACTGT -> CGCAGGTCGCCGGACTGTC
CCGCATATTTCAATAGAAA -> CGCATATTTCAATAGAAAT
CCGCATCACGAGAAGGTGT -> CGCATCACGAGAAGGTGTC
CCGCCATATACGTACTGCG -> CGCCATATACGTACTGCGA
CCGCCCACTAGACCGCGCG -> CGCCCACTAGACCGCGCGT
CCGCGAAAGAATGCGTTGC -> CGCGAAAGAATGCGTTGCT
CCGCGCCGTCCATGACCTG -> CGCGCCGTCCATGACCTGT
CCGCGCGATCGTTTCCGGT -> CGCGCGATCGTTTCCGGTA
CCGCGCGTGGATTTGTTAG -> CGCGCGTGGATTTGTTAGA
CCGCGTCCGACCTCGCAGG -> CGCGTCCGACCTCGCAGGG
CCGGAAAGGCACTAATACC -> CGGAAAGGCACTAATACCG
CCGGAACCACACTCCCCGA -> CGGAACCACACTCCCCGAT
CCGGACAGCCTGGCACTAG -> CGGACAGCCTGGCACTAGG
CCGGACTGTCCAAAACATC -> CGGACTGTCCAAAACATCT
CCGGATATTGGATCGATAG -> CGGATATTGGATCGATAGC
CCGGCTCTGGAGTGTACGG -> CGGCTCTGGAGTGTACGGG
CCGGGCGGGAATAGCCATT -> CGGGCGGGAATAGCCATTG
CCGGTAGTTTTCCCCACAT -> CGGTAGTTTTCCCCACATT
CCGTATCCTCAAGGGAAGT -> CGTATCCTCAAGGGAAGTA
CCGTCCATGACCTGTTGCT -> CGTCCATGACCTGTTGCTA
CCGTCTCGGAAATTTCTTC -> CGTCTCGGAAATTTCTTCA
CCGTGCAGAGTCGTCTAGC -> CGTGCAGAGTCGTCTAGCT
CCGTGCTTAAGAAATGTTC -> CGTGCTTAAGAAATGTTCT
CCGTGTCGTATTCATCTAA -> CGTGTCGTATTCATCTAAC
CCGTTCCAGCGCTAATGCG -> CGTTCCAGCGCTAATGCGC
CCGTTCCAGGTGCCAAGTA -> CGTTCCAGGTGCCAAGTAG
CCTACGGCTACTCCAACAA -> CTACGGCTACTCCAACAAA
CCTACTCGGATCGACGCAG -> CTACTCGGATCGACGCAGT
CCTACTTTCTTGTTTCGGA -> CTACTTTCTTGTTTCGGAC
CCTAGAAAGGCGTGAGTCG -> CTAGAAAGGCGTGAGTCGT
CCTAGAACACTATGAAACC -> CTAGAACACTATGAAACCT
CCTAGTTCCAACAAATCTT -> CTAGTTCCAACAAATCTTG
CCTCAAGGGAAGTACCGAA -> CTCAAGGGAAGTACCGAAT
CCTCAGCTACCATGCTCGG -> CTCAGCTACCATGCTCGGT
CCTCCCTGGAATCTTACTC -> CTCCCTGGAATCTTACTCT
CCTCCTACTCGGATCGACG -> CTCCTACTCGGATCGACGC
CCTCGATGGTATATAGAAT -> CTCGATGGTATATAGAATT
CCTCGCAGGGGGACCTTTT -> CTCGCAGGGGGACCTTTTG
CCTCGCGTCATATTCAAGA -> CTCGCGTCATATTCAAGAA
CCTCTAGATCCCGTGCAGA -> CTCTAGATCCCGTGCAGAG
CCTCTGCTTTGCTCTCCGC -> CTCTGCTTTGCTCTCCGCG
CCTGCCTTGAATCGCACAT -> CTGCCTTGAATCGCACATT
CCTGGAATCTTACTCTTTA -> CTGGAATCTTACTCTTTAC
CCTGGCACCGTTCCAGCGC -> CTGGCACCGTTCCAGCGCT
CCTGGCACTAGGATCCATA -> CTGGCACTAGGATCCATAC
CCTGGTAGTGCCCCAAAGC -> CTGGTAGTGCCCCAAAGCC
CCTGTAGTGCTCACTCAAC -> CTGTAGTGCTCACTCAACA
CCTGTATCACGCCGCATAT -> CTGTATCACGCCGCATATT
CCTGTCGCATCGGCCGGAC -> CTGTCGCATCGGCCGGACA
CCTGTTGCTATGATGGCAC -> CTGTTGCTATGATGGCACA
CCTTAACTTGAGGACTTAC -> CTTAACTTGAGGACTTACT
CCTTACTTGGAGGCACAAA -> CTTACTTGGAGGCACAAAT
CCTTAGCAGCTGTGATGGC -> CTTAGCAGCTGTGATGGCG
CCTTATGCCTAGAAAGGCG -> CTTATGCCTAGAAAGGCGT
CCTTATTCAGAGATGTGCT -> CTTATTCAGAGATGTGCTC
CCTTCAATTAGCTGAGCAG -> CTTCAATTAGCTGAGCAGG
CCTTCGTTAGACATCCGTA -> CTTCGTTAGACATCCGTAT
CCTTGAATCGCACATTAAA -> CTTGAATCGCACATTAAAG
CCTTGTCGGACTAACACGT -> CTTGTCGGACTAACACGTT
CCTTTGCCACAGCTAGTAG -> CTTTGCCACAGCTAGTAGG
CCTTTTGTACGTTCCCGTG -> CTTTTGTACGTTCCCGTGT
CGAAAACACGCTGTAAGTC -> GAAAACACGCTGTAAGTCT
CGAAACCAATGCTCGCAGA -> GAAACCAATGCTCGCAGAG
CGAAACTCTTTAATAGATC -> GAAACTCTTTAATAGATCC
CGAAAGAATGCGTTGCTAA -> GAAAGAATGCGTTGCTAAG
CGAACATGTTTCGATTAAG -> GAACATGTTTCGATTAAGT
CGAACCTGTCGCATCGGCC -> GAACCTGTCGCATCGGCCG
CGAATAACAAAGTATGGTC -> GAATAACAAAGTATGGTCT
CGAATATTTGGATATCGGT -> GAATATTTGGATATCGGTT
CGAATTCGGGCGTTTTACG -> GAATTCGGGCGTTTTACGC
CGAATTTTCGGTTCCTCCT -> GAATTTTCGGTTCCTCCTA
CGACCCACAATAATGTTAG -> GACCCACAATAATGTTAGC
CGACCGTGCTTAAGAAATG -> GACCGTGCTTAAGAAATGT
CGACCTCGCAGGGGGACCT -> GACCTCGCAGGGGGACCTT
CGACGCAGTTTGGGAGCCT -> GACGCAGTTTGGGAGCCTT
CGACGGTTAACAGTCCAAC -> GACGGTTAACAGTCCAACA
CGACTAATTTCCACTCGCG -> GACTAATTTCCACTCGCGT
CGAGAAGGTGTCTGAAGAA -> GAGAAGGTGTCTGAAGAAT
CGAGACAGACCGCATCACG -> GAGACAGACCGCATCACGA
CGAGAGCAGCCATATTCAC -> GAGAGCAGCCATATTCACC
CGAGGCATAGGGCTGGCTG -> GAGGCATAGGGCTGGCTGG
CGAGTTCCAAACGTCAACG -> GAGTTCCAAACGTCAACGC
CGATAGCCTTGTCGGACTA -> GATAGCCTTGTCGGACTAA
CGATCCATTGCGTCCTCTG -> GATCCATTGCGTCCTCTGC
CGATCGTTTCCGGTAGTTT -> GATCGTTTCCGGTAGTTTT
CGATGGTATATAGAATTAA -> GATGGTATATAGAATTAAC
CGATGTCAACATTGCAGTG -> GATGTCAACATTGCAGTGA
CGATTAAGTTCTGAAAAAT -> GATTAAGTTCTGAAAAATG
CGATTCGACCCACAATAAT -> GATTCGACCCACAATAATG
CGCACACCCTCCCTGGAAT -> GCACACCCTCCCTGGAATC
CGCACATTAAAGGTGGATG -> GCACATTAAAGGTGGATGA
CGCACGCGAACATGTTTCG -> GCACGCGAACATGTTTCGA
CGCACTCCAATCTGGAGTA -> GCACTCCAATCTGGAGTAA
CGCAGAGAACTCGCTGCCC -> GCAGAGAACTCGCTGCCCC
CGCAGGGGGACCTTTTGTA -> GCAGGGGGACCTTTTGTAC
CGCAGGTCGCCGGACTGTC -> GCAGGTCGCCGGACTGTCC
CGCAGTTTGGGAGCCTTCG -> GCAGTTTGGGAGCCTTCGT
CGCATATTTCAATAGAAAT -> GCATATTTCAATAGAAATA
CGCATCACGAGAAGGTGTC -> GCATCACGAGAAGGTGTCT
CGCATCGGCCGGACAGCCT -> GCATCGGCCGGACAGCCTG
CGCCACGTGTAGGACACGA -> GCCACGTGTAGGACACGAA
CGCCATATACGTACTGCGA -> GCCATATACGTACTGCGAA
CGCCCACTAGACCGCGCGT -> GCCCACTAGACCGCGCGTG
CGCCCCTCGATGGTATATA -> GCCCCTCGATGGTATATAG
CGCCCTTAGCAGCTGTGAT -> GCCCTTAGCAGCTGTGATG
CGCCCTTCAATTAGCTGAG -> GCCCTTCAATTAGCTGAGC
CGCCGACCGTGCTTAAGAA -> GCCGACCGTGCTTAAGAAA
CGCCGCATATTTCAATAGA -> GCCGCATATTTCAATAGAA
CGCCGGACTGTCCAAAACA -> GCCGGACTGTCCAAAACAT
CGCCGGATATTGGATCGAT -> GCCGGATATTGGATCGATA
CGCCGTCCATGACCTGTTG -> GCCGTCCATGACCTGTTGC
CGCCTACGGCTACTCCAAC -> GCCTACGGCTACTCCAACA
CGCCTGTATCACGCCGCAT -> GCCTGTATCACGCCGCATA
CGCGAAAGAATGCGTTGCT -> GCGAAAGAATGCGTTGCTA
CGCGAACATGTTTCGATTA -> GCGAACATGTTTCGATTAA
CGCGATCGTTTCCGGTAGT -> GCGATCGTTTCCGGTAGTT
CGCGCCGTCCATGACCTGT -> GCGCCGTCCATGACCTGTT
CGCGCGATCGTTTCCGGTA -> GCGCGATCGTTTCCGGTAG
CGCGCGGATTCCGTTCCAG -> GCGCGGATTCCGTTCCAGG
CGCGCGTGGATTTGTTAGA -> GCGCGTGGATTTGTTAGAA
CGCGCTTTTGTAGCCGAAT -> GCGCTTTTGTAGCCGAATT
CGCGGATTCCGTTCCAGGT -> GCGGATTCCGTTCCAGGTG
CGCGTCATATTCAAGAACA -> GCGTCATATTCAAGAACAA
CGCGTCCGACCTCGCAGGG -> GCGTCCGACCTCGCAGGGG
CGCGTGGATTTGTTAGAAA -> GCGTGGATTTGTTAGAAAT
CGCGTGTCACGTTTTAGGC -> GCGTGTCACGTTTTAGGCG
CGCTAATGCGCCGACCGTG -> GCTAATGCGCCGACCGTGC
CGCTGCCCCGACTAATTTC -> GCTGCCCCGACTAATTTCC
CGCTGTAAGTCTCAGGTGA -> GCTGTAAGTCTCAGGTGAT
CGCTTTTGTAGCCGAATTT -> GCTTTTGTAGCCGAATTTT
CGGAAAGGCACTAATACCG -> GGAAAGGCACTAATACCGA
CGGAAATTTCTTCATGAGT -> GGAAATTTCTTCATGAGTC
CGGAACCACACTCCCCGAT -> GGAACCACACTCCCCGATC
CGGAACGCGCTTTTGTAGC -> GGAACGCGCTTTTGTAGCC
CGGACAGCCTGGCACTAGG -> GGACAGCCTGGCACTAGGA
CGGACAGCTAGGGTCCAAC -> GGACAGCTAGGGTCCAACA
CGGACGTAACGTCCACACG -> GGACGTAACGTCCACACGG
CGGACTAACACGTTATGTA -> GGACTAACACGTTATGTAA
CGGACTGTCCAAAACATCT -> GGACTGTCCAAAACATCTA
CGGATATTGGATCGATAGC -> GGATATTGGATCGATAGCC
CGGATCGACGCAGTTTGGG -> GGATCGACGCAGTTTGGGA
CGGATTCCGTTCCAGGTGC -> GGATTCCGTTCCAGGTGCC
CGGATTTGTCACTGGTAGT -> GGATTTGTCACTGGTAGTC
CGGCCCCCTGTAGTGCTCA -> GGCCCCCTGTAGTGCTCAC
CGGCCGGACAGCCTGGCAC -> GGCCGGACAGCCTGGCACT
CGGCTACTCCAACAAATCT -> GGCTACTCCAACAAATCTT
CGGCTCTGGAGTGTACGGG -> GGCTCTGGAGTGTACGGGT
CGGGAATAGCCATTGTGAA -> GGGAATAGCCATTGTGAAT
CGGGCGGGAATAGCCATTG -> GGGCGGGAATAGCCATTGT
CGGGCGTTTTACGACGGTT -> GGGCGTTTTACGACGGTTA
CGGGCGTTTTACGCCTACG -> GGGCGTTTTACGCCTACGG
CGGGCGTTTTACGGACAGC -> GGGCGTTTTACGGACAGCT
CGGGCGTTTTACGTGACAC -> GGGCGTTTTACGTGACACC
CGGGCTTGACGAAAACACG -> GGGCTTGACGAAAACACGC
CGGGGGATTCTCCCGCCCA -> GGGGGATTCTCCCGCCCAC
CGGGTTAGGTTCTATCAAT -> GGGTTAGGTTCTATCAATG
CGGTAGTTTTCCCCACATT -> GGTAGTTTTCCCCACATTC
CGGTATGCCGGAACCACAC -> GGTATGCCGGAACCACACT
CGGTCTTTTGCACAGGATC -> GGTCTTTTGCACAGGATCA
CGGTTAACAGTCCAACAAA -> GGTTAACAGTCCAACAAAT
CGGTTCCTCCTACTCGGAT -> GGTTCCTCCTACTCGGATC
CGGTTCTGAAATAAGAGAC -> GGTTCTGAAATAAGAGACA
CGGTTGAGGCGGGGGATTC -> GGTTGAGGCGGGGGATTCT
CGGTTTTTCCTCGCGTCAT -> GGTTTTTCCTCGCGTCATA
CGTAACGTCCACACGGCCC -> GTAACGTCCACACGGCCCC
CGTACTGCGAAACTCTTTA -> GTACTGCGAAACTCTTTAA
CGTAGGGCCGCCATATACG -> GTAGGGCCGCCATATACGT
CGTATCCTCAAGGGAAGTA -> GTATCCTCAAGGGAAGTAC
CGTATTCATCTAACTACAT -> GTATTCATCTAACTACATT
CGTCAACGCCCCTCGATGG -> GTCAACGCCCCTCGATGGT
CGTCATATTCAAGAACAAG -> GTCATATTCAAGAACAAGG
CGTCCACACGGCCCCCTGT -> GTCCACACGGCCCCCTGTA
CGTCCATGACCTGTTGCTA -> GTCCATGACCTGTTGCTAT
CGTCCGACCTCGCAGGGGG -> GTCCGACCTCGCAGGGGGA
CGTCCTCTGCTTTGCTCTC -> GTCCTCTGCTTTGCTCTCC
CGTCTAGCTTCAACAGGGG -> GTCTAGCTTCAACAGGGGC
CGTCTCGGAAATTTCTTCA -> GTCTCGGAAATTTCTTCAT
CGTCTCTGAAAACCTTACT -> GTCTCTGAAAACCTTACTT
CGTGACACCTAGTTCCAAC -> GTGACACCTAGTTCCAACA
CGTGAGTCGTGTCCCGTCT -> GTGAGTCGTGTCCCGTCTC
CGTGATGGACAACTTATTG -> GTGATGGACAACTTATTGA
CGTGCAGAGTCGTCTAGCT -> GTGCAGAGTCGTCTAGCTT
CGTGCTTAAGAAATGTTCT -> GTGCTTAAGAAATGTTCTA
CGTGGATTTGTTAGAAATC -> GTGGATTTGTTAGAAATCG
CGTGGGAACTAGTAGAATT -> GTGGGAACTAGTAGAATTG
CGTGTAGGACACGAATATT -> GTGTAGGACACGAATATTT
CGTGTCACGTTTTAGGCGA -> GTGTCACGTTTTAGGCGAT
CGTGTCCCGTCTCGGAAAT -> GTGTCCCGTCTCGGAAATT
CGTGTCGTATTCATCTAAC -> GTGTCGTATTCATCTAACT
CGTGTCTCGAATTCGGGCG -> GTGTCTCGAATTCGGGCGT
CGTTAGACATCCGTATCCT -> GTTAGACATCCGTATCCTC
CGTTATGTAAAAGGAGACC -> GTTATGTAAAAGGAGACCA
CGTTCCACCCGCGCGATCG -> GTTCCACCCGCGCGATCGT
CGTTCCAGCGCTAATGCGC -> GTTCCAGCGCTAATGCGCC
CGTTCCAGGTGCCAAGTAG -> GTTCCAGGTGCCAAGTAGC
CGTTCCCCTGGCACCGTTC -> GTTCCCCTGGCACCGTTCC
CGTTCCCGTGTCGTATTCA -> GTTCCCGTGTCGTATTCAT
CGTTGCTAAGCGCACACCC -> GTTGCTAAGCGCACACCCT
CGTTTAAACGGTTCTGAAA -> GTTTAAACGGTTCTGAAAT
CGTTTCCGGTAGTTTTCCC -> GTTTCCGGTAGTTTTCCCC
CGTTTTACGACGGTTAACA -> GTTTTACGACGGTTAACAG
CGTTTTACGCCTACGGCTA -> GTTTTACGCCTACGGCTAC
CGTTTTACGGACAGCTAGG -> GTTTTACGGACAGCTAGGG
CGTTTTACGTGACACCTAG -> GTTTTACGTGACACCTAGT
CGTTTTAGGCGATGTCAAC -> GTTTTAGGCGATGTCAACA
CTAAAAAATATTTCCACCC -> TAAAAAATATTTCCACCCC
CTAACACGTTATGTAAAAG -> TAACACGTTATGTAAAAGG
CTAACTACATTGTGACTGC -> TAACTACATTGTGACTGCT
CTAAGCGCACACCCTCCCT -> TAAGCGCACACCCTCCCTG
CTAATACCGAGGCATAGGG -> TAATACCGAGGCATAGGGC
CTAATGCGCCGACCGTGCT -> TAATGCGCCGACCGTGCTT
CTAATTTCCACTCGCGTGT -> TAATTTCCACTCGCGTGTC
CTACATTGTGACTGCTGCG -> TACATTGTGACTGCTGCGC
CTACCATGCTCGGTTTTTC -> TACCATGCTCGGTTTTTCC
CTACGGCTACTCCAACAAA -> TACGGCTACTCCAACAAAT
CTACTCCAACAAATCTTGT -> TACTCCAACAAATCTTGTG
CTACTCCTTTGCCACAGCT -> TACTCCTTTGCCACAGCTA
CTACTCGGATCGACGCAGT -> TACTCGGATCGACGCAGTT
CTACTTTCTTGTTTCGGAC -> TACTTTCTTGTTTCGGACG
CTAGAAAGGCGTGAGTCGT -> TAGAAAGGCGTGAGTCGTG
CTAGAACACTATGAAACCT -> TAGAACACTATGAAACCTT
CTAGACCGCGCGTGGATTT -> TAGACCGCGCGTGGATTTG
CTAGATCCCGTGCAGAGTC -> TAGATCCCGTGCAGAGTCG
CTAGCTTCAACAGGGGCTT -> TAGCTTCAACAGGGGCTTT
CTAGGATCCATACCGCACG -> TAGGATCCATACCGCACGC
CTAGGGGAATTCGGGCGTT -> TAGGGGAATTCGGGCGTTT
CTAGGGTCCAACAAATCTT -> TAGGGTCCAACAAATCTTG
CTAGTAGAATTGTAAAGAC -> TAGTAGAATTGTAAAGACG
CTAGTAGGAATAGTTGTCG -> TAGTAGGAATAGTTGTCGT
CTAGTTCCAACAAATCTTG -> TAGTTCCAACAAATCTTGT
CTATCAATGTCGTCTCTGA -> TATCAATGTCGTCTCTGAA
CTATGAAACCTTATGCCTA -> TATGAAACCTTATGCCTAG
CTATGATGGCACACTACTC -> TATGATGGCACACTACTCC
CTATGTCTGTTTTGGGTGA -> TATGTCTGTTTTGGGTGAA
CTATGTTGCCCTCAGCTAC -> TATGTTGCCCTCAGCTACC
CTCAACAGTTCTCCGAGTT -> TCAACAGTTCTCCGAGTTC
CTCAAGGGAAGTACCGAAT -> TCAAGGGAAGTACCGAATA
CTCACGTGGGAACTAGTAG -> TCACGTGGGAACTAGTAGA
CTCACTCAACAGTTCTCCG -> TCACTCAACAGTTCTCCGA
CTCACTCACGTGGGAACTA -> TCACTCACGTGGGAACTAG
CTCAGCTACCATGCTCGGT -> TCAGCTACCATGCTCGGTT
CTCAGGTGATAGATTGTTA -> TCAGGTGATAGATTGTTAA
CTCCAACAAATCTTGTGAG -> TCCAACAAATCTTGTGAGC
CTCCAATCTGGAGTAATGC -> TCCAATCTGGAGTAATGCA
CTCCAGGGCAAGAGCCAAA -> TCCAGGGCAAGAGCCAAAG
CTCCCCGATCCATTGCGTC -> TCCCCGATCCATTGCGTCC
CTCCCGCCCACTAGACCGC -> TCCCGCCCACTAGACCGCG
CTCCCTGGAATCTTACTCT -> TCCCTGGAATCTTACTCTT
CTCCGAGTTCCAAACGTCA -> TCCGAGTTCCAAACGTCAA
CTCCGCGCCGTCCATGACC -> TCCGCGCCGTCCATGACCT
CTCCTACTCGGATCGACGC -> TCCTACTCGGATCGACGCA
CTCCTTTGCCACAGCTAGT -> TCCTTTGCCACAGCTAGTA
CTCGAATTCGGGCGTTTTA -> TCGAATTCGGGCGTTTTAC
CTCGATGGTATATAGAATT -> TCGATGGTATATAGAATTA
CTCGCAGAGAACTCGCTGC -> TCGCAGAGAACTCGCTGCC
CTCGCAGGGGGACCTTTTG -> TCGCAGGGGGACCTTTTGT
CTCGCGTCATATTCAAGAA -> TCGCGTCATATTCAAGAAC
CTCGCGTGTCACGTTTTAG -> TCGCGTGTCACGTTTTAGG
CTCGCTGCCCCGACTAATT -> TCGCTGCCCCGACTAATTT
CTCGGAAATTTCTTCATGA -> TCGGAAATTTCTTCATGAG
CTCGGATCGACGCAGTTTG -> TCGGATCGACGCAGTTTGG
CTCGGTTTTTCCTCGCGTC -> TCGGTTTTTCCTCGCGTCA
CTCTAGATCCCGTGCAGAG -> TCTAGATCCCGTGCAGAGT
CTCTCCGCGCCGTCCATGA -> TCTCCGCGCCGTCCATGAC
CTCTGAAAACCTTACTTGG -> TCTGAAAACCTTACTTGGA
CTCTGCTTTGCTCTCCGCG -> TCTGCTTTGCTCTCCGCGC
CTCTGGAGTGTACGGGTTA -> TCTGGAGTGTACGGGTTAG
CTCTTTAATAGATCCGCGA -> TCTTTAATAGATCCGCGAA
CTCTTTACTTTTGTAGGCC -> TCTTTACTTTTGTAGGCCG
CTCTTTCTATGTTGCCCTC -> TCTTTCTATGTTGCCCTCA
CTGAAAAATGCGTGTCTCG -> TGAAAAATGCGTGTCTCGA
CTGAAAACCTTACTTGGAG -> TGAAAACCTTACTTGGAGG
CTGAAATAAGAGACAGGTT -> TGAAATAAGAGACAGGTTC
CTGAAGAATTCGGGCGTTT -> TGAAGAATTCGGGCGTTTT
CTGAGCAGGCCACGTTCCC -> TGAGCAGGCCACGTTCCCC
CTGCAGGCAACCCTGGTAG -> TGCAGGCAACCCTGGTAGT
CTGCCCCGACTAATTTCCA -> TGCCCCGACTAATTTCCAC
CTGCCTTGAATCGCACATT -> TGCCTTGAATCGCACATTA
CTGCGAAACTCTTTAATAG -> TGCGAAACTCTTTAATAGA
CTGCGCCCTTAGCAGCTGT -> TGCGCCCTTAGCAGCTGTG
CTGCTGCGCCCTTAGCAGC -> TGCTGCGCCCTTAGCAGCT
CTGCTTTGCTCTCCGCGCC -> TGCTTTGCTCTCCGCGCCG
CTGGAATCTTACTCTTTAC -> TGGAATCTTACTCTTTACT
CTGGACGTGATGGACAACT -> TGGACGTGATGGACAACTT
CTGGAGTGTACGGGTTAGG -> TGGAGTGTACGGGTTAGGT
CTGGCACCGTTCCAGCGCT -> TGGCACCGTTCCAGCGCTA
CTGGCACTAGGATCCATAC -> TGGCACTAGGATCCATACC
CTGGCGGAACGCGCTTTTG -> TGGCGGAACGCGCTTTTGT
CTGGCTGGACGTGATGGAC -> TGGCTGGACGTGATGGACA
CTGGTAGTCCAGAGGTCTC -> TGGTAGTCCAGAGGTCTCC
CTGGTAGTGCCCCAAAGCC -> TGGTAGTGCCCCAAAGCCA
CTGGTCTTATGTTAGCGAA -> TGGTCTTATGTTAGCGAAA
CTGGTGGCCGGGCGGGAAT -> TGGTGGCCGGGCGGGAATA
CTGTAAGTCTCAGGTGATA -> TGTAAGTCTCAGGTGATAG
CTGTAGTGCTCACTCAACA -> TGTAGTGCTCACTCAACAG
CTGTATCACGCCGCATATT -> TGTATCACGCCGCATATTT
CTGTCCAAAACATCTATGT -> TGTCCAAAACATCTATGTC
CTGTCGCATCGGCCGGACA -> TGTCGCATCGGCCGGACAG
CTGTGATGGCGGTATGCCG -> TGTGATGGCGGTATGCCGG
CTGTGCCCTCTAGATCCCG -> TGTGCCCTCTAGATCCCGT
CTGTTCATCCTAGAACACT -> TGTTCATCCTAGAACACTA
CTGTTGCTATGATGGCACA -> TGTTGCTATGATGGCACAC
CTGTTTTGGGTGAAAACTA -> TGTTTTGGGTGAAAACTAA
CTTAACTTGAGGACTTACT -> TTAACTTGAGGACTTACTT
CTTAAGAAATGTTCTAGGG -> TTAAGAAATGTTCTAGGGG
CTTACTCTTTACTTTTGTA -> TTACTCTTTACTTTTGTAG
CTTACTTCTGGTCTTATGT -> TTACTTCTGGTCTTATGTT
CTTACTTGGAGGCACAAAT -> TTACTTGGAGGCACAAATG
CTTAGCAGCTGTGATGGCG -> TTAGCAGCTGTGATGGCGG
CTTATCGTTCCACCCGCGC -> TTATCGTTCCACCCGCGCG
CTTATGCCTAGAAAGGCGT -> TTATGCCTAGAAAGGCGTG
CTTATGTTAGCGAAACCAA -> TTATGTTAGCGAAACCAAT
CTTATTCAGAGATGTGCTC -> TTATTCAGAGATGTGCTCA
CTTATTGAGCCCGCGTCCG -> TTATTGAGCCCGCGTCCGA
CTTCAACAGGGGCTTTTAC -> TTCAACAGGGGCTTTTACC
CTTCAATTAGCTGAGCAGG -> TTCAATTAGCTGAGCAGGC
CTTCATGAGTCGGTCTTTT -> TTCATGAGTCGGTCTTTTG
CTTCCAACTGGCGGAACGC -> TTCCAACTGGCGGAACGCG
CTTCGTTAGACATCCGTAT -> TTCGTTAGACATCCGTATC
CTTCTGGTCTTATGTTAGC -> TTCTGGTCTTATGTTAGCG
CTTGAATCGCACATTAAAG -> TTGAATCGCACATTAAAGG
CTTGACGAAAACACGCTGT -> TTGACGAAAACACGCTGTA
CTTGAGGACTTACTTCTGG -> TTGAGGACTTACTTCTGGT
CTTGGAGGCACAAATGCGC -> TTGGAGGCACAAATGCGCC
CTTGGTCAGTCCGGCTCTG -> TTGGTCAGTCCGGCTCTGG
CTTGTAGTACTTATCGTTC -> TTGTAGTACTTATCGTTCC
CTTGTCGGACTAACACGTT -> TTGTCGGACTAACACGTTA
CTTGTGAGCATGGGTTAGT -> TTGTGAGCATGGGTTAGTT
CTTGTGAGCCAGTTGTAGC -> TTGTGAGCCAGTTGTAGCT
CTTGTGAGCGGATTTGTCA -> TTGTGAGCGGATTTGTCAC
CTTGTGAGCTTGTTGTTTT -> TTGTGAGCTTGTTGTTTTA
CTTGTTGTTTTACCATATT -> TTGTTGTTTTACCATATTC
CTTGTTTCGGACGTAACGT -> TTGTTTCGGACGTAACGTC
CTTTAATAGATCCGCGAAA -> TTTAATAGATCCGCGAAAG
CTTTACTTTTGTAGGCCGC -> TTTACTTTTGTAGGCCGCA
CTTTCTATGTTGCCCTCAG -> TTTCTATGTTGCCCTCAGC
CTTTCTTGTTTCGGACGTA -> TTTCTTGTTTCGGACGTAA
CTTTGCCACAGCTAGTAGG -> TTTGCCACAGCTAGTAGGA
CTTTGCTCTCCGCGCCGTC -> TTTGCTCTCCGCGCCGTCC
CTTTTACCTTAACTTGAGG -> TTTTACCTTAACTTGAGGA
CTTTTGCACAGGATCAGGA -> TTTTGCACAGGATCAGGAC
CTTTTGTACGTTCCCGTGT -> TTTTGTACGTTCCCGTGTC
CTTTTGTAGCCGAATTTTC -> TTTTGTAGCCGAATTTTCG
CTTTTGTAGGCCGCAGGTC -> TTTTGTAGGCCGCAGGTCG
GAAAAATGCGTGTCTCGAA -> AAAAATGCGTGTCTCGAAT
GAAAACACGCTGTAAGTCT -> AAAACACGCTGTAAGTCTC
GAAAACCTTACTTGGAGGC -> AAAACCTTACTTGGAGGCA
GAAAACTAAAAAATATTTC -> AAAACTAAAAAATATTTCC
GAAACCAATGCTCGCAGAG -> AAACCAATGCTCGCAGAGA
GAAACCTTATGCCTAGAAA -> AAACCTTATGCCTAGAAAG
GAAACTCTTTAATAGATCC -> AAACTCTTTAATAGATCCG
GAAAGAATGCGTTGCTAAG -> AAAGAATGCGTTGCTAAGC
GAAAGGCACTAATACCGAG -> AAAGGCACTAATACCGAGG
GAAAGGCGTGAGTCGTGTC -> AAAGGCGTGAGTCGTGTCC
GAAATAAGAGACAGGTTCT -> AAATAAGAGACAGGTTCTG
GAAATACTGCAGGCAACCC -> AAATACTGCAGGCAACCCT
GAAATCGCCTGTATCACGC -> AAATCGCCTGTATCACGCC
GAAATGTTCTAGGGGAATT -> AAATGTTCTAGGGGAATTC
GAAATTTCTTCATGAGTCG -> AAATTTCTTCATGAGTCGG
GAACAAGGCCGAGACAGAC -> AACAAGGCCGAGACAGACC
GAACACTATGAAACCTTAT -> AACACTATGAAACCTTATG
GAACATGTTTCGATTAAGT -> AACATGTTTCGATTAAGTT
GAACCACACTCCCCGATCC -> AACCACACTCCCCGATCCA
GAACCTGTCGCATCGGCCG -> AACCTGTCGCATCGGCCGG
GAACGCGCTTTTGTAGCCG -> AACGCGCTTTTGTAGCCGA
GAACTAGTAGAATTGTAAA -> AACTAGTAGAATTGTAAAG
GAACTCGCTGCCCCGACTA -> AACTCGCTGCCCCGACTAA
GAAGAATTCGGGCGTTTTA -> AAGAATTCGGGCGTTTTAC
GAAGGTGTCTGAAGAATTC -> AAGGTGTCTGAAGAATTCG
GAAGTACCGAATAACAAAG -> AAGTACCGAATAACAAAGT
GAATAACAAAGTATGGTCT -> AATAACAAAGTATGGTCTT
GAATAGCCATTGTGAATTC -> AATAGCCATTGTGAATTCG
GAATAGTTGTCGTTTAAAC -> AATAGTTGTCGTTTAAACG
GAATATTTGGATATCGGTT -> AATATTTGGATATCGGTTG
GAATCGCACATTAAAGGTG -> AATCGCACATTAAAGGTGG
GAATCTTACTCTTTACTTT -> AATCTTACTCTTTACTTTT
GAATGCGTTGCTAAGCGCA -> AATGCGTTGCTAAGCGCAC
GAATTAACATGATTACGAA -> AATTAACATGATTACGAAC
GAATTCGGGCGTTTTACGA -> AATTCGGGCGTTTTACGAC
GAATTCGGGCGTTTTACGC -> AATTCGGGCGTTTTACGCC
GAATTCGGGCGTTTTACGG -> AATTCGGGCGTTTTACGGA
GAATTCGGGCGTTTTACGT -> AATTCGGGCGTTTTACGTG
GAATTGTAAAGACGCACTC -> AATTGTAAAGACGCACTCC
GAATTTTCGGTTCCTCCTA -> AATTTTCGGTTCCTCCTAC
GACAACTTATTGAGCCCGC -> ACAACTTATTGAGCCCGCG
GACACCTAGTTCCAACAAA -> ACACCTAGTTCCAACAAAT
GACACGAATATTTGGATAT -> ACACGAATATTTGGATATC
GACAGACCGCATCACGAGA -> ACAGACCGCATCACGAGAA
GACAGCCTGGCACTAGGAT -> ACAGCCTGGCACTAGGATC
GACAGCTAGGGTCCAACAA -> ACAGCTAGGGTCCAACAAA
GACAGGTTCTGGTGGCCGG -> ACAGGTTCTGGTGGCCGGG
GACATCCGTATCCTCAAGG -> ACATCCGTATCCTCAAGGG
GACCATGCTCTTTCTATGT -> ACCATGCTCTTTCTATGTT
GACCCACAATAATGTTAGC -> ACCCACAATAATGTTAGCG
GACCGCATCACGAGAAGGT -> ACCGCATCACGAGAAGGTG
GACCGCGCGTGGATTTGTT -> ACCGCGCGTGGATTTGTTA
GACCGTGCTTAAGAAATGT -> ACCGTGCTTAAGAAATGTT
GACCTCGCAGGGGGACCTT -> ACCTCGCAGGGGGACCTTT
GACCTGTTGCTATGATGGC -> ACCTGTTGCTATGATGGCA
GACCTTTTGTACGTTCCCG -> ACCTTTTGTACGTTCCCGT
GACGAAAACACGCTGTAAG -> ACGAAAACACGCTGTAAGT
GACGATTCGACCCACAATA -> ACGATTCGACCCACAATAA
GACGCACTCCAATCTGGAG -> ACGCACTCCAATCTGGAGT
GACGCAGTTTGGGAGCCTT -> ACGCAGTTTGGGAGCCTTC
GACGGTTAACAGTCCAACA -> ACGGTTAACAGTCCAACAA
GACGTAACGTCCACACGGC -> ACGTAACGTCCACACGGCC
GACGTGATGGACAACTTAT -> ACGTGATGGACAACTTATT
GACTAACACGTTATGTAAA -> ACTAACACGTTATGTAAAA
GACTAATTTCCACTCGCGT -> ACTAATTTCCACTCGCGTG
GACTGCTGCGCCCTTAGCA -> ACTGCTGCGCCCTTAGCAG
GACTGTCCAAAACATCTAT -> ACTGTCCAAAACATCTATG
GACTTACTTCTGGTCTTAT -> ACTTACTTCTGGTCTTATG
GAGAACTCGCTGCCCCGAC -> AGAACTCGCTGCCCCGACT
GAGAAGGTGTCTGAAGAAT -> AGAAGGTGTCTGAAGAATT
GAGACAGACCGCATCACGA -> AGACAGACCGCATCACGAG
GAGACAGGTTCTGGTGGCC -> AGACAGGTTCTGGTGGCCG
GAGACCATGCTCTTTCTAT -> AGACCATGCTCTTTCTATG
GAGAGCAGCCATATTCACC -> AGAGCAGCCATATTCACCC
GAGATGTGCTCACTCACGT -> AGATGTGCTCACTCACGTG
GAGCAGCCATATTCACCCT -> AGCAGCCATATTCACCCTT
GAGCAGGCCACGTTCCCCT -> AGCAGGCCACGTTCCCCTG
GAGCATGGGTTAGTTGGGG -> AGCATGGGTTAGTTGGGGC
GAGCCAAAGGCGCGCGGAT -> AGCCAAAGGCGCGCGGATT
GAGCCAGTTGTAGCTGTTC -> AGCCAGTTGTAGCTGTTCA
GAGCCCGCGTCCGACCTCG -> AGCCCGCGTCCGACCTCGC
GAGCCTTCGTTAGACATCC -> AGCCTTCGTTAGACATCCG
GAGCGGATTTGTCACTGGT -> AGCGGATTTGTCACTGGTA
GAGCTTGTTGTTTTACCAT -> AGCTTGTTGTTTTACCATA
GAGGACTTACTTCTGGTCT -> AGGACTTACTTCTGGTCTT
GAGGCACAAATGCGCCACG -> AGGCACAAATGCGCCACGT
GAGGCATAGGGCTGGCTGG -> AGGCATAGGGCTGGCTGGA
GAGGCGGGGGATTCTCCCG -> AGGCGGGGGATTCTCCCGC
GAGGTCTCCAGGGCAAGAG -> AGGTCTCCAGGGCAAGAGC
GAGTCGGTCTTTTGCACAG -> AGTCGGTCTTTTGCACAGG
GAGTCGTCTAGCTTCAACA -> AGTCGTCTAGCTTCAACAG
GAGTCGTGTCCCGTCTCGG -> AGTCGTGTCCCGTCTCGGA
GAGTGTACGGGTTAGGTTC -> AGTGTACGGGTTAGGTTCT
GAGTTCCAAACGTCAACGC -> AGTTCCAAACGTCAACGCC
GAGTTCGGGCTTGACGAAA -> AGTTCGGGCTTGACGAAAA
GATAGATTGTTAATCGCCG -> ATAGATTGTTAATCGCCGG
GATAGCCTTGTCGGACTAA -> ATAGCCTTGTCGGACTAAC
GATATCGGTTGAGGCGGGG -> ATATCGGTTGAGGCGGGGG
GATATTGGATCGATAGCCT -> ATATTGGATCGATAGCCTT
GATCAGGACGATTCGACCC -> ATCAGGACGATTCGACCCA
GATCCATACCGCACGCGAA -> ATCCATACCGCACGCGAAC
GATCCATTGCGTCCTCTGC -> ATCCATTGCGTCCTCTGCT
GATCCCGTGCAGAGTCGTC -> ATCCCGTGCAGAGTCGTCT
GATCCGCGAAAGAATGCGT -> ATCCGCGAAAGAATGCGTT
GATCGACGCAGTTTGGGAG -> ATCGACGCAGTTTGGGAGC
GATCGATAGCCTTGTCGGA -> ATCGATAGCCTTGTCGGAC
GATCGTTTCCGGTAGTTTT -> ATCGTTTCCGGTAGTTTTC
GATGAGTTCGGGCTTGACG -> ATGAGTTCGGGCTTGACGA
GATGGACAACTTATTGAGC -> ATGGACAACTTATTGAGCC
GATGGCACACTACTCCTTT -> ATGGCACACTACTCCTTTG
GATGGCGGTATGCCGGAAC -> ATGGCGGTATGCCGGAACC
GATGGTATATAGAATTAAC -> ATGGTATATAGAATTAACA
GATGTCAACATTGCAGTGA -> ATGTCAACATTGCAGTGAT
GATGTGCTCACTCACGTGG -> ATGTGCTCACTCACGTGGG
GATTAAGTTCTGAAAAATG -> ATTAAGTTCTGAAAAATGC
GATTACGAACCTGTCGCAT -> ATTACGAACCTGTCGCATC
GATTCAATCATTGGTACTT -> ATTCAATCATTGGTACTTG
GATTCCGTTCCAGGTGCCA -> ATTCCGTTCCAGGTGCCAA
GATTCGACCCACAATAATG -> ATTCGACCCACAATAATGT
GATTCTCCCGCCCACTAGA -> ATTCTCCCGCCCACTAGAC
GATTGTTAATCGCCGGATA -> ATTGTTAATCGCCGGATAT
GATTTGTCACTGGTAGTCC -> ATTTGTCACTGGTAGTCCA
GATTTGTTAGAAATCGCCT -> ATTTGTTAGAAATCGCCTG
GCAACCCTGGTAGTGCCCC -> CAACCCTGGTAGTGCCCCA
GCAAGAGCCAAAGGCGCGC -> CAAGAGCCAAAGGCGCGCG
GCACAAATGCGCCACGTGT -> CACAAATGCGCCACGTGTA
GCACACCCTCCCTGGAATC -> CACACCCTCCCTGGAATCT
GCACACTACTCCTTTGCCA -> CACACTACTCCTTTGCCAC
GCACAGGATCAGGACGATT -> CACAGGATCAGGACGATTC
GCACATTAAAGGTGGATGA -> CACATTAAAGGTGGATGAG
GCACCGTTCCAGCGCTAAT -> CACCGTTCCAGCGCTAATG
GCACGCGAACATGTTTCGA -> CACGCGAACATGTTTCGAT
GCACTAATACCGAGGCATA -> CACTAATACCGAGGCATAG
GCACTAGGATCCATACCGC -> CACTAGGATCCATACCGCA
GCACTCCAATCTGGAGTAA -> CACTCCAATCTGGAGTAAT
GCAGAGAACTCGCTGCCCC -> CAGAGAACTCGCTGCCCCG
GCAGAGTCGTCTAGCTTCA -> CAGAGTCGTCTAGCTTCAA
GCAGCCATATTCACCCTTA -> CAGCCATATTCACCCTTAT
GCAGCTGTGATGGCGGTAT -> CAGCTGTGATGGCGGTATG
GCAGGCAACCCTGGTAGTG -> CAGGCAACCCTGGTAGTGC
GCAGGCCACGTTCCCCTGG -> CAGGCCACGTTCCCCTGGC
GCAGGGGGACCTTTTGTAC -> CAGGGGGACCTTTTGTACG
GCAGGTCGCCGGACTGTCC -> CAGGTCGCCGGACTGTCCA
GCAGTGATTCAATCATTGG -> CAGTGATTCAATCATTGGT
GCAGTTGTCTGTGCCCTCT -> CAGTTGTCTGTGCCCTCTA
GCAGTTTGGGAGCCTTCGT -> CAGTTTGGGAGCCTTCGTT
GCATAGGGCTGGCTGGACG -> CATAGGGCTGGCTGGACGT
GCATATTTCAATAGAAATA -> CATATTTCAATAGAAATAC
GCATCACGAGAAGGTGTCT -> CATCACGAGAAGGTGTCTG
GCATCCTGCCTTGAATCGC -> CATCCTGCCTTGAATCGCA
GCATCGGCCGGACAGCCTG -> CATCGGCCGGACAGCCTGG
GCATGGGTTAGTTGGGGCC -> CATGGGTTAGTTGGGGCCG
GCCAAACCTACTTTCTTGT -> CCAAACCTACTTTCTTGTT
GCCAAAGGCGCGCGGATTC -> CCAAAGGCGCGCGGATTCC
GCCAAGTAGCTTCCAACTG -> CCAAGTAGCTTCCAACTGG
GCCACAGCTAGTAGGAATA -> CCACAGCTAGTAGGAATAG
GCCACGTGTAGGACACGAA -> CCACGTGTAGGACACGAAT
GCCACGTTCCCCTGGCACC -> CCACGTTCCCCTGGCACCG
GCCAGTTGTAGCTGTTCAT -> CCAGTTGTAGCTGTTCATC
GCCATATACGTACTGCGAA -> CCATATACGTACTGCGAAA
GCCATATTCACCCTTATTC -> CCATATTCACCCTTATTCA
GCCATTGTGAATTCGGGCG -> CCATTGTGAATTCGGGCGT
GCCCACTAGACCGCGCGTG -> CCCACTAGACCGCGCGTGG
GCCCCAAAGCCAAACCTAC -> CCCCAAAGCCAAACCTACT
GCCCCCTGTAGTGCTCACT -> CCCCCTGTAGTGCTCACTC
GCCCCGACTAATTTCCACT -> CCCCGACTAATTTCCACTC
GCCCCTCGATGGTATATAG -> CCCCTCGATGGTATATAGA
GCCCGCGTCCGACCTCGCA -> CCCGCGTCCGACCTCGCAG
GCCCTCAGCTACCATGCTC -> CCCTCAGCTACCATGCTCG
GCCCTCTAGATCCCGTGCA -> CCCTCTAGATCCCGTGCAG
GCCCTTAGCAGCTGTGATG -> CCCTTAGCAGCTGTGATGG
GCCCTTCAATTAGCTGAGC -> CCCTTCAATTAGCTGAGCA
GCCGAATTTTCGGTTCCTC -> CCGAATTTTCGGTTCCTCC
GCCGACCGTGCTTAAGAAA -> CCGACCGTGCTTAAGAAAT
GCCGAGACAGACCGCATCA -> CCGAGACAGACCGCATCAC
GCCGAGAGCAGCCATATTC -> CCGAGAGCAGCCATATTCA
GCCGCAGGTCGCCGGACTG -> CCGCAGGTCGCCGGACTGT
GCCGCATATTTCAATAGAA -> CCGCATATTTCAATAGAAA
GCCGCCATATACGTACTGC -> CCGCCATATACGTACTGCG
GCCGGAACCACACTCCCCG -> CCGGAACCACACTCCCCGA
GCCGGACAGCCTGGCACTA -> CCGGACAGCCTGGCACTAG
GCCGGACTGTCCAAAACAT -> CCGGACTGTCCAAAACATC
GCCGGATATTGGATCGATA -> CCGGATATTGGATCGATAG
GCCGGGCGGGAATAGCCAT -> CCGGGCGGGAATAGCCATT
GCCGTCCATGACCTGTTGC -> CCGTCCATGACCTGTTGCT
GCCTACGGCTACTCCAACA -> CCTACGGCTACTCCAACAA
GCCTAGAAAGGCGTGAGTC -> CCTAGAAAGGCGTGAGTCG
GCCTGGCACTAGGATCCAT -> CCTGGCACTAGGATCCATA
GCCTGTATCACGCCGCATA -> CCTGTATCACGCCGCATAT
GCCTTCGTTAGACATCCGT -> CCTTCGTTAGACATCCGTA
GCCTTGAATCGCACATTAA -> CCTTGAATCGCACATTAAA
GCCTTGTCGGACTAACACG -> CCTTGTCGGACTAACACGT
GCGAAACCAATGCTCGCAG -> CGAAACCAATGCTCGCAGA
GCGAAACTCTTTAATAGAT -> CGAAACTCTTTAATAGATC
GCGAAAGAATGCGTTGCTA -> CGAAAGAATGCGTTGCTAA
GCGAACATGTTTCGATTAA -> CGAACATGTTTCGATTAAG
GCGATCGTTTCCGGTAGTT -> CGATCGTTTCCGGTAGTTT
GCGATGTCAACATTGCAGT -> CGATGTCAACATTGCAGTG
GCGCACACCCTCCCTGGAA -> CGCACACCCTCCCTGGAAT
GCGCCACGTGTAGGACACG -> CGCCACGTGTAGGACACGA
GCGCCCTTAGCAGCTGTGA -> CGCCCTTAGCAGCTGTGAT
GCGCCCTTCAATTAGCTGA -> CGCCCTTCAATTAGCTGAG
GCGCCGACCGTGCTTAAGA -> CGCCGACCGTGCTTAAGAA
GCGCCGTCCATGACCTGTT -> CGCCGTCCATGACCTGTTG
GCGCGATCGTTTCCGGTAG -> CGCGATCGTTTCCGGTAGT
GCGCGCGGATTCCGTTCCA -> CGCGCGGATTCCGTTCCAG
GCGCGGATTCCGTTCCAGG -> CGCGGATTCCGTTCCAGGT
GCGCGTGGATTTGTTAGAA -> CGCGTGGATTTGTTAGAAA
GCGCTAATGCGCCGACCGT -> CGCTAATGCGCCGACCGTG
GCGCTTTTGTAGCCGAATT -> CGCTTTTGTAGCCGAATTT
GCGGAACGCGCTTTTGTAG -> CGGAACGCGCTTTTGTAGC
GCGGATTCCGTTCCAGGTG -> CGGATTCCGTTCCAGGTGC
GCGGATTTGTCACTGGTAG -> CGGATTTGTCACTGGTAGT
GCGGGAATAGCCATTGTGA -> CGGGAATAGCCATTGTGAA
GCGGGGGATTCTCCCGCCC -> CGGGGGATTCTCCCGCCCA
GCGGTATGCCGGAACCACA -> CGGTATGCCGGAACCACAC
GCGTCATATTCAAGAACAA -> CGTCATATTCAAGAACAAG
GCGTCCGACCTCGCAGGGG -> CGTCCGACCTCGCAGGGGG
GCGTCCTCTGCTTTGCTCT -> CGTCCTCTGCTTTGCTCTC
GCGTGAGTCGTGTCCCGTC -> CGTGAGTCGTGTCCCGTCT
GCGTGGATTTGTTAGAAAT -> CGTGGATTTGTTAGAAATC
GCGTGTCACGTTTTAGGCG -> CGTGTCACGTTTTAGGCGA
GCGTGTCTCGAATTCGGGC -> CGTGTCTCGAATTCGGGCG
GCGTTGCTAAGCGCACACC -> CGTTGCTAAGCGCACACCC
GCGTTTTACGACGGTTAAC -> CGTTTTACGACGGTTAACA
GCGTTTTACGCCTACGGCT -> CGTTTTACGCCTACGGCTA
GCGTTTTACGGACAGCTAG -> CGTTTTACGGACAGCTAGG
GCGTTTTACGTGACACCTA -> CGTTTTACGTGACACCTAG
GCTAAGCGCACACCCTCCC -> CTAAGCGCACACCCTCCCT
GCTAATGCGCCGACCGTGC -> CTAATGCGCCGACCGTGCT
GCTACCATGCTCGGTTTTT -> CTACCATGCTCGGTTTTTC
GCTACTCCAACAAATCTTG -> CTACTCCAACAAATCTTGT
GCTAGGGTCCAACAAATCT -> CTAGGGTCCAACAAATCTT
GCTAGTAGGAATAGTTGTC -> CTAGTAGGAATAGTTGTCG
GCTATGATGGCACACTACT -> CTATGATGGCACACTACTC
GCTCACTCAACAGTTCTCC -> CTCACTCAACAGTTCTCCG
GCTCACTCACGTGGGAACT -> CTCACTCACGTGGGAACTA
GCTCGCAGAGAACTCGCTG -> CTCGCAGAGAACTCGCTGC
GCTCGGTTTTTCCTCGCGT -> CTCGGTTTTTCCTCGCGTC
GCTCTCCGCGCCGTCCATG -> CTCTCCGCGCCGTCCATGA
GCTCTGGAGTGTACGGGTT -> CTCTGGAGTGTACGGGTTA
GCTCTTTCTATGTTGCCCT -> CTCTTTCTATGTTGCCCTC
GCTGAGCAGGCCACGTTCC -> CTGAGCAGGCCACGTTCCC
GCTGCCCCGACTAATTTCC -> CTGCCCCGACTAATTTCCA
GCTGCGCCCTTAGCAGCTG -> CTGCGCCCTTAGCAGCTGT
GCTGGACGTGATGGACAAC -> CTGGACGTGATGGACAACT
GCTGGCTGGACGTGATGGA -> CTGGCTGGACGTGATGGAC
GCTGTAAGTCTCAGGTGAT -> CTGTAAGTCTCAGGTGATA
GCTGTGATGGCGGTATGCC -> CTGTGATGGCGGTATGCCG
GCTGTTCATCCTAGAACAC -> CTGTTCATCCTAGAACACT
GCTTAAGAAATGTTCTAGG -> CTTAAGAAATGTTCTAGGG
GCTTCAACAGGGGCTTTTA -> CTTCAACAGGGGCTTTTAC
GCTTCCAACTGGCGGAACG -> CTTCCAACTGGCGGAACGC
GCTTGACGAAAACACGCTG -> CTTGACGAAAACACGCTGT
GCTTGTTGTTTTACCATAT -> CTTGTTGTTTTACCATATT
GCTTTGCTCTCCGCGCCGT -> CTTTGCTCTCCGCGCCGTC
GCTTTTACCTTAACTTGAG -> CTTTTACCTTAACTTGAGG
GCTTTTGTAGCCGAATTTT -> CTTTTGTAGCCGAATTTTC
GGAAAGGCACTAATACCGA -> GAAAGGCACTAATACCGAG
GGAAATTTCTTCATGAGTC -> GAAATTTCTTCATGAGTCG
GGAACCACACTCCCCGATC -> GAACCACACTCCCCGATCC
GGAACGCGCTTTTGTAGCC -> GAACGCGCTTTTGTAGCCG
GGAACTAGTAGAATTGTAA -> GAACTAGTAGAATTGTAAA
GGAAGTACCGAATAACAAA -> GAAGTACCGAATAACAAAG
GGAATAGCCATTGTGAATT -> GAATAGCCATTGTGAATTC
GGAATAGTTGTCGTTTAAA -> GAATAGTTGTCGTTTAAAC
GGAATCTTACTCTTTACTT -> GAATCTTACTCTTTACTTT
GGAATTCGGGCGTTTTACG -> GAATTCGGGCGTTTTACGG
GGACAACTTATTGAGCCCG -> GACAACTTATTGAGCCCGC
GGACACGAATATTTGGATA -> GACACGAATATTTGGATAT
GGACAGCCTGGCACTAGGA -> GACAGCCTGGCACTAGGAT
GGACAGCTAGGGTCCAACA -> GACAGCTAGGGTCCAACAA
GGACCTTTTGTACGTTCCC -> GACCTTTTGTACGTTCCCG
GGACGATTCGACCCACAAT -> GACGATTCGACCCACAATA
GGACGTAACGTCCACACGG -> GACGTAACGTCCACACGGC
GGACGTGATGGACAACTTA -> GACGTGATGGACAACTTAT
GGACTAACACGTTATGTAA -> GACTAACACGTTATGTAAA
GGACTGTCCAAAACATCTA -> GACTGTCCAAAACATCTAT
GGACTTACTTCTGGTCTTA -> GACTTACTTCTGGTCTTAT
GGAGACCATGCTCTTTCTA -> GAGACCATGCTCTTTCTAT
GGAGCCTTCGTTAGACATC -> GAGCCTTCGTTAGACATCC
GGAGGCACAAATGCGCCAC -> GAGGCACAAATGCGCCACG
GGAGTGTACGGGTTAGGTT -> GAGTGTACGGGTTAGGTTC
GGATATCGGTTGAGGCGGG -> GATATCGGTTGAGGCGGGG
GGATATTGGATCGATAGCC -> GATATTGGATCGATAGCCT
GGATCAGGACGATTCGACC -> GATCAGGACGATTCGACCC
GGATCCATACCGCACGCGA -> GATCCATACCGCACGCGAA
GGATCGACGCAGTTTGGGA -> GATCGACGCAGTTTGGGAG
GGATCGATAGCCTTGTCGG -> GATCGATAGCCTTGTCGGA
GGATGAGTTCGGGCTTGAC -> GATGAGTTCGGGCTTGACG
GGATTCCGTTCCAGGTGCC -> GATTCCGTTCCAGGTGCCA
GGATTCTCCCGCCCACTAG -> GATTCTCCCGCCCACTAGA
GGATTTGTCACTGGTAGTC -> GATTTGTCACTGGTAGTCC
GGATTTGTTAGAAATCGCC -> GATTTGTTAGAAATCGCCT
GGCAACCCTGGTAGTGCCC -> GCAACCCTGGTAGTGCCCC
GGCAAGAGCCAAAGGCGCG -> GCAAGAGCCAAAGGCGCGC
GGCACAAATGCGCCACGTG -> GCACAAATGCGCCACGTGT
GGCACACTACTCCTTTGCC -> GCACACTACTCCTTTGCCA
GGCACCGTTCCAGCGCTAA -> GCACCGTTCCAGCGCTAAT
GGCACTAATACCGAGGCAT -> GCACTAATACCGAGGCATA
GGCACTAGGATCCATACCG -> GCACTAGGATCCATACCGC
GGCATAGGGCTGGCTGGAC -> GCATAGGGCTGGCTGGACG
GGCCACGTTCCCCTGGCAC -> GCCACGTTCCCCTGGCACC
GGCCCCCTGTAGTGCTCAC -> GCCCCCTGTAGTGCTCACT
GGCCGAGACAGACCGCATC -> GCCGAGACAGACCGCATCA
GGCCGAGAGCAGCCATATT -> GCCGAGAGCAGCCATATTC
GGCCGCAGGTCGCCGGACT -> GCCGCAGGTCGCCGGACTG
GGCCGCCATATACGTACTG -> GCCGCCATATACGTACTGC
GGCCGGACAGCCTGGCACT -> GCCGGACAGCCTGGCACTA
GGCCGGGCGGGAATAGCCA -> GCCGGGCGGGAATAGCCAT
GGCGATGTCAACATTGCAG -> GCGATGTCAACATTGCAGT
GGCGCGCGGATTCCGTTCC -> GCGCGCGGATTCCGTTCCA
GGCGGAACGCGCTTTTGTA -> GCGGAACGCGCTTTTGTAG
GGCGGGAATAGCCATTGTG -> GCGGGAATAGCCATTGTGA
GGCGGGGGATTCTCCCGCC -> GCGGGGGATTCTCCCGCCC
GGCGGTATGCCGGAACCAC -> GCGGTATGCCGGAACCACA
GGCGTGAGTCGTGTCCCGT -> GCGTGAGTCGTGTCCCGTC
GGCGTTTTACGACGGTTAA -> GCGTTTTACGACGGTTAAC
GGCGTTTTACGCCTACGGC -> GCGTTTTACGCCTACGGCT
GGCGTTTTACGGACAGCTA -> GCGTTTTACGGACAGCTAG
GGCGTTTTACGTGACACCT -> GCGTTTTACGTGACACCTA
GGCTACTCCAACAAATCTT -> GCTACTCCAACAAATCTTG
GGCTCTGGAGTGTACGGGT -> GCTCTGGAGTGTACGGGTT
GGCTGGACGTGATGGACAA -> GCTGGACGTGATGGACAAC
GGCTGGCTGGACGTGATGG -> GCTGGCTGGACGTGATGGA
GGCTTGACGAAAACACGCT -> GCTTGACGAAAACACGCTG
GGCTTTTACCTTAACTTGA -> GCTTTTACCTTAACTTGAG
GGGAACTAGTAGAATTGTA -> GGAACTAGTAGAATTGTAA
GGGAAGTACCGAATAACAA -> GGAAGTACCGAATAACAAA
GGGAATAGCCATTGTGAAT -> GGAATAGCCATTGTGAATT
GGGAATTCGGGCGTTTTAC -> GGAATTCGGGCGTTTTACG
GGGACCTTTTGTACGTTCC -> GGACCTTTTGTACGTTCCC
GGGAGCCTTCGTTAGACAT -> GGAGCCTTCGTTAGACATC
GGGATTCTCCCGCCCACTA -> GGATTCTCCCGCCCACTAG
GGGCAAGAGCCAAAGGCGC -> GGCAAGAGCCAAAGGCGCG
GGGCCGAGAGCAGCCATAT -> GGCCGAGAGCAGCCATATT
GGGCCGCCATATACGTACT -> GGCCGCCATATACGTACTG
GGGCGGGAATAGCCATTGT -> GGCGGGAATAGCCATTGTG
GGGCGTTTTACGACGGTTA -> GGCGTTTTACGACGGTTAA
GGGCGTTTTACGCCTACGG -> GGCGTTTTACGCCTACGGC
GGGCGTTTTACGGACAGCT -> GGCGTTTTACGGACAGCTA
GGGCGTTTTACGTGACACC -> GGCGTTTTACGTGACACCT
GGGCTGGCTGGACGTGATG -> GGCTGGCTGGACGTGATGG
GGGCTTGACGAAAACACGC -> GGCTTGACGAAAACACGCT
GGGCTTTTACCTTAACTTG -> GGCTTTTACCTTAACTTGA
GGGGAATTCGGGCGTTTTA -> GGGAATTCGGGCGTTTTAC
GGGGACCTTTTGTACGTTC -> GGGACCTTTTGTACGTTCC
GGGGATTCTCCCGCCCACT -> GGGATTCTCCCGCCCACTA
GGGGCCGAGAGCAGCCATA -> GGGCCGAGAGCAGCCATAT
GGGGCTTTTACCTTAACTT -> GGGCTTTTACCTTAACTTG
GGGGGACCTTTTGTACGTT -> GGGGACCTTTTGTACGTTC
GGGGGATTCTCCCGCCCAC -> GGGGATTCTCCCGCCCACT
GGGTCCAACAAATCTTGTG -> GGTCCAACAAATCTTGTGA
GGGTGAAAACTAAAAAATA -> GGTGAAAACTAAAAAATAT
GGGTTAGGTTCTATCAATG -> GGTTAGGTTCTATCAATGT
GGGTTAGTTGGGGCCGAGA -> GGTTAGTTGGGGCCGAGAG
GGTACTTGGTCAGTCCGGC -> GTACTTGGTCAGTCCGGCT
GGTAGTCCAGAGGTCTCCA -> GTAGTCCAGAGGTCTCCAG
GGTAGTGCCCCAAAGCCAA -> GTAGTGCCCCAAAGCCAAA
GGTAGTTTTCCCCACATTC -> GTAGTTTTCCCCACATTCG
GGTATATAGAATTAACATG -> GTATATAGAATTAACATGA
GGTATGCCGGAACCACACT -> GTATGCCGGAACCACACTC
GGTCAGTCCGGCTCTGGAG -> GTCAGTCCGGCTCTGGAGT
GGTCCAACAAATCTTGTGA -> GTCCAACAAATCTTGTGAG
GGTCGCCGGACTGTCCAAA -> GTCGCCGGACTGTCCAAAA
GGTCTCCAGGGCAAGAGCC -> GTCTCCAGGGCAAGAGCCA
GGTCTTATGTTAGCGAAAC -> GTCTTATGTTAGCGAAACC
GGTCTTGTAGTACTTATCG -> GTCTTGTAGTACTTATCGT
GGTCTTTTGCACAGGATCA -> GTCTTTTGCACAGGATCAG
GGTGAAAACTAAAAAATAT -> GTGAAAACTAAAAAATATT
GGTGATAGATTGTTAATCG -> GTGATAGATTGTTAATCGC
GGTGCCAAGTAGCTTCCAA -> GTGCCAAGTAGCTTCCAAC
GGTGGATGAGTTCGGGCTT -> GTGGATGAGTTCGGGCTTG
GGTGGCCGGGCGGGAATAG -> GTGGCCGGGCGGGAATAGC
GGTGTCTGAAGAATTCGGG -> GTGTCTGAAGAATTCGGGC
GGTTAACAGTCCAACAAAT -> GTTAACAGTCCAACAAATC
GGTTAGGTTCTATCAATGT -> GTTAGGTTCTATCAATGTC
GGTTAGTTGGGGCCGAGAG -> GTTAGTTGGGGCCGAGAGC
GGTTCCTCCTACTCGGATC -> GTTCCTCCTACTCGGATCG
GGTTCTATCAATGTCGTCT -> GTTCTATCAATGTCGTCTC
GGTTCTGAAATAAGAGACA -> GTTCTGAAATAAGAGACAG
GGTTCTGGTGGCCGGGCGG -> GTTCTGGTGGCCGGGCGGG
GGTTGAGGCGGGGGATTCT -> GTTGAGGCGGGGGATTCTC
GGTTTTTCCTCGCGTCATA -> GTTTTTCCTCGCGTCATAT
GTAAAAGGAGACCATGCTC -> TAAAAGGAGACCATGCTCT
GTAAAGACGCACTCCAATC -> TAAAGACGCACTCCAATCT
GTAACGTCCACACGGCCCC -> TAACGTCCACACGGCCCCC
GTAAGTCTCAGGTGATAGA -> TAAGTCTCAGGTGATAGAT
GTACCGAATAACAAAGTAT -> TACCGAATAACAAAGTATG
GTACGGGTTAGGTTCTATC -> TACGGGTTAGGTTCTATCA
GTACGTTCCCGTGTCGTAT -> TACGTTCCCGTGTCGTATT
GTACTGCGAAACTCTTTAA -> TACTGCGAAACTCTTTAAT
GTACTTATCGTTCCACCCG -> TACTTATCGTTCCACCCGC
GTACTTGGTCAGTCCGGCT -> TACTTGGTCAGTCCGGCTC
GTAGAATTGTAAAGACGCA -> TAGAATTGTAAAGACGCAC
GTAGCCGAATTTTCGGTTC -> TAGCCGAATTTTCGGTTCC
GTAGCTGTTCATCCTAGAA -> TAGCTGTTCATCCTAGAAC
GTAGCTTCCAACTGGCGGA -> TAGCTTCCAACTGGCGGAA
GTAGGAATAGTTGTCGTTT -> TAGGAATAGTTGTCGTTTA
GTAGGACACGAATATTTGG -> TAGGACACGAATATTTGGA
GTAGGCCGCAGGTCGCCGG -> TAGGCCGCAGGTCGCCGGA
GTAGGGCCGCCATATACGT -> TAGGGCCGCCATATACGTA
GTAGTACTTATCGTTCCAC -> TAGTACTTATCGTTCCACC
GTAGTCCAGAGGTCTCCAG -> TAGTCCAGAGGTCTCCAGG
GTAGTGCCCCAAAGCCAAA -> TAGTGCCCCAAAGCCAAAC
GTAGTGCTCACTCAACAGT -> TAGTGCTCACTCAACAGTT
GTAGTTTTCCCCACATTCG -> TAGTTTTCCCCACATTCGT
GTATATAGAATTAACATGA -> TATATAGAATTAACATGAT
GTATCACGCCGCATATTTC -> TATCACGCCGCATATTTCA
GTATCCTCAAGGGAAGTAC -> TATCCTCAAGGGAAGTACC
GTATGCCGGAACCACACTC -> TATGCCGGAACCACACTCC
GTATGGTCTTGTAGTACTT -> TATGGTCTTGTAGTACTTA
GTATTCATCTAACTACATT -> TATTCATCTAACTACATTG
GTCAACATTGCAGTGATTC -> TCAACATTGCAGTGATTCA
GTCAACGCCCCTCGATGGT -> TCAACGCCCCTCGATGGTA
GTCACGTTTTAGGCGATGT -> TCACGTTTTAGGCGATGTC
GTCACTGGTAGTCCAGAGG -> TCACTGGTAGTCCAGAGGT
GTCAGTCCGGCTCTGGAGT -> TCAGTCCGGCTCTGGAGTG
GTCATATTCAAGAACAAGG -> TCATATTCAAGAACAAGGC
GTCCAAAACATCTATGTCT -> TCCAAAACATCTATGTCTG
GTCCAACAAATCTTGTGAG -> TCCAACAAATCTTGTGAGC,TCCAACAAATCTTGTGAGC
GTCCACACGGCCCCCTGTA -> TCCACACGGCCCCCTGTAG
GTCCAGAGGTCTCCAGGGC -> TCCAGAGGTCTCCAGGGCA
GTCCATGACCTGTTGCTAT -> TCCATGACCTGTTGCTATG
GTCCCGTCTCGGAAATTTC -> TCCCGTCTCGGAAATTTCT
GTCCGACCTCGCAGGGGGA -> TCCGACCTCGCAGGGGGAC
GTCCGGCTCTGGAGTGTAC -> TCCGGCTCTGGAGTGTACG
GTCCTCTGCTTTGCTCTCC -> TCCTCTGCTTTGCTCTCCG
GTCGCATCGGCCGGACAGC -> TCGCATCGGCCGGACAGCC
GTCGCCGGACTGTCCAAAA -> TCGCCGGACTGTCCAAAAC
GTCGGACTAACACGTTATG -> TCGGACTAACACGTTATGT
GTCGGTCTTTTGCACAGGA -> TCGGTCTTTTGCACAGGAT
GTCGTATTCATCTAACTAC -> TCGTATTCATCTAACTACA
GTCGTCTAGCTTCAACAGG -> TCGTCTAGCTTCAACAGGG
GTCGTCTCTGAAAACCTTA -> TCGTCTCTGAAAACCTTAC
GTCGTGTCCCGTCTCGGAA -> TCGTGTCCCGTCTCGGAAA
GTCGTTTAAACGGTTCTGA -> TCGTTTAAACGGTTCTGAA
GTCTAGCTTCAACAGGGGC -> TCTAGCTTCAACAGGGGCT
GTCTCAGGTGATAGATTGT -> TCTCAGGTGATAGATTGTT
GTCTCCAGGGCAAGAGCCA -> TCTCCAGGGCAAGAGCCAA
GTCTCGAATTCGGGCGTTT -> TCTCGAATTCGGGCGTTTT
GTCTCGGAAATTTCTTCAT -> TCTCGGAAATTTCTTCATG
GTCTCTGAAAACCTTACTT -> TCTCTGAAAACCTTACTTG
GTCTGAAGAATTCGGGCGT -> TCTGAAGAATTCGGGCGTT
GTCTGTGCCCTCTAGATCC -> TCTGTGCCCTCTAGATCCC
GTCTGTTTTGGGTGAAAAC -> TCTGTTTTGGGTGAAAACT
GTCTTATGTTAGCGAAACC -> TCTTATGTTAGCGAAACCA
GTCTTGTAGTACTTATCGT -> TCTTGTAGTACTTATCGTT
GTCTTTTGCACAGGATCAG -> TCTTTTGCACAGGATCAGG
GTGAAAACTAAAAAATATT -> TGAAAACTAAAAAATATTT
GTGAATTCGGGCGTTTTAC -> TGAATTCGGGCGTTTTACG
GTGACACCTAGTTCCAACA -> TGACACCTAGTTCCAACAA
GTGACTGCTGCGCCCTTAG -> TGACTGCTGCGCCCTTAGC
GTGAGCATGGGTTAGTTGG -> TGAGCATGGGTTAGTTGGG
GTGAGCCAGTTGTAGCTGT -> TGAGCCAGTTGTAGCTGTT
GTGAGCGGATTTGTCACTG -> TGAGCGGATTTGTCACTGG
GTGAGCTTGTTGTTTTACC -> TGAGCTTGTTGTTTTACCA
GTGAGTCGTGTCCCGTCTC -> TGAGTCGTGTCCCGTCTCG
GTGATAGATTGTTAATCGC -> TGATAGATTGTTAATCGCC
GTGATGGACAACTTATTGA -> TGATGGACAACTTATTGAG
GTGATGGCGGTATGCCGGA -> TGATGGCGGTATGCCGGAA
GTGATTCAATCATTGGTAC -> TGATTCAATCATTGGTACT
GTGCAGAGTCGTCTAGCTT -> TGCAGAGTCGTCTAGCTTC
GTGCCAAGTAGCTTCCAAC -> TGCCAAGTAGCTTCCAACT
GTGCCCCAAAGCCAAACCT -> TGCCCCAAAGCCAAACCTA
GTGCCCTCTAGATCCCGTG -> TGCCCTCTAGATCCCGTGC
GTGCTCACTCAACAGTTCT -> TGCTCACTCAACAGTTCTC
GTGCTCACTCACGTGGGAA -> TGCTCACTCACGTGGGAAC
GTGCTTAAGAAATGTTCTA -> TGCTTAAGAAATGTTCTAG
GTGGATGAGTTCGGGCTTG -> TGGATGAGTTCGGGCTTGA
GTGGATTTGTTAGAAATCG -> TGGATTTGTTAGAAATCGC
GTGGCCGGGCGGGAATAGC -> TGGCCGGGCGGGAATAGCC
GTGGGAACTAGTAGAATTG -> TGGGAACTAGTAGAATTGT
GTGTACGGGTTAGGTTCTA -> TGTACGGGTTAGGTTCTAT
GTGTAGGACACGAATATTT -> TGTAGGACACGAATATTTG
GTGTCACGTTTTAGGCGAT -> TGTCACGTTTTAGGCGATG
GTGTCCCGTCTCGGAAATT -> TGTCCCGTCTCGGAAATTT
GTGTCGTATTCATCTAACT -> TGTCGTATTCATCTAACTA
GTGTCTCGAATTCGGGCGT -> TGTCTCGAATTCGGGCGTT
GTGTCTGAAGAATTCGGGC -> TGTCTGAAGAATTCGGGCG
GTTAACAGTCCAACAAATC -> TTAACAGTCCAACAAATCT
GTTAATCGCCGGATATTGG -> TTAATCGCCGGATATTGGA
GTTAGAAATCGCCTGTATC -> TTAGAAATCGCCTGTATCA
GTTAGACATCCGTATCCTC -> TTAGACATCCGTATCCTCA
GTTAGCGAAACCAATGCTC -> TTAGCGAAACCAATGCTCG
GTTAGCGCCCTTCAATTAG -> TTAGCGCCCTTCAATTAGC
GTTAGGTTCTATCAATGTC -> TTAGGTTCTATCAATGTCG
GTTAGTTGGGGCCGAGAGC -> TTAGTTGGGGCCGAGAGCA
GTTATGTAAAAGGAGACCA -> TTATGTAAAAGGAGACCAT
GTTCATCCTAGAACACTAT -> TTCATCCTAGAACACTATG
GTTCCAAACGTCAACGCCC -> TTCCAAACGTCAACGCCCC
GTTCCAACAAATCTTGTGA -> TTCCAACAAATCTTGTGAG
GTTCCACCCGCGCGATCGT -> TTCCACCCGCGCGATCGTT
GTTCCAGCGCTAATGCGCC -> TTCCAGCGCTAATGCGCCG
GTTCCAGGTGCCAAGTAGC -> TTCCAGGTGCCAAGTAGCT
GTTCCCCTGGCACCGTTCC -> TTCCCCTGGCACCGTTCCA
GTTCCCGTGTCGTATTCAT -> TTCCCGTGTCGTATTCATC
GTTCCTCCTACTCGGATCG -> TTCCTCCTACTCGGATCGA
GTTCGGGCTTGACGAAAAC -> TTCGGGCTTGACGAAAACA
GTTCTAGGGGAATTCGGGC -> TTCTAGGGGAATTCGGGCG
GTTCTATCAATGTCGTCTC -> TTCTATCAATGTCGTCTCT
GTTCTCCGAGTTCCAAACG -> TTCTCCGAGTTCCAAACGT
GTTCTGAAAAATGCGTGTC -> TTCTGAAAAATGCGTGTCT
GTTCTGAAATAAGAGACAG -> TTCTGAAATAAGAGACAGG
GTTCTGGTGGCCGGGCGGG -> TTCTGGTGGCCGGGCGGGA
GTTGAGGCGGGGGATTCTC -> TTGAGGCGGGGGATTCTCC
GTTGCCCTCAGCTACCATG -> TTGCCCTCAGCTACCATGC
GTTGCTAAGCGCACACCCT -> TTGCTAAGCGCACACCCTC
GTTGCTATGATGGCACACT -> TTGCTATGATGGCACACTA
GTTGGGGCCGAGAGCAGCC -> TTGGGGCCGAGAGCAGCCA
GTTGTAGCTGTTCATCCTA -> TTGTAGCTGTTCATCCTAG
GTTGTCGTTTAAACGGTTC -> TTGTCGTTTAAACGGTTCT
GTTGTCTGTGCCCTCTAGA -> TTGTCTGTGCCCTCTAGAT
GTTGTTTTACCATATTCAT -> TTGTTTTACCATATTCATA
GTTTAAACGGTTCTGAAAT -> TTTAAACGGTTCTGAAATA
GTTTCCGGTAGTTTTCCCC -> TTTCCGGTAGTTTTCCCCA
GTTTCGATTAAGTTCTGAA -> TTTCGATTAAGTTCTGAAA
GTTTCGGACGTAACGTCCA -> TTTCGGACGTAACGTCCAC
GTTTGGGAGCCTTCGTTAG -> TTTGGGAGCCTTCGTTAGA
GTTTTACCATATTCATAGC -> TTTTACCATATTCATAGCA
GTTTTACGACGGTTAACAG -> TTTTACGACGGTTAACAGT
GTTTTACGCCTACGGCTAC -> TTTTACGCCTACGGCTACT
GTTTTACGGACAGCTAGGG -> TTTTACGGACAGCTAGGGT
GTTTTACGTGACACCTAGT -> TTTTACGTGACACCTAGTT
GTTTTAGGCGATGTCAACA -> TTTTAGGCGATGTCAACAT
GTTTTCCCCACATTCGTAG -> TTTTCCCCACATTCGTAGG
GTTTTGGGTGAAAACTAAA -> TTTTGGGTGAAAACTAAAA
GTTTTTCCTCGCGTCATAT -> TTTTTCCTCGCGTCATATT
TAAAAAATATTTCCACCCC -> AAAAAATATTTCCACCCCG
TAAAAGGAGACCATGCTCT -> AAAAGGAGACCATGCTCTT
TAAACGGTTCTGAAATAAG -> AAACGGTTCTGAAATAAGA
TAAAGACGCACTCCAATCT -> AAAGACGCACTCCAATCTG
TAAAGGTGGATGAGTTCGG -> AAAGGTGGATGAGTTCGGG
TAACAAAGTATGGTCTTGT -> AACAAAGTATGGTCTTGTA
TAACACGTTATGTAAAAGG -> AACACGTTATGTAAAAGGA
TAACAGTCCAACAAATCTT -> AACAGTCCAACAAATCTTG
TAACATGATTACGAACCTG -> AACATGATTACGAACCTGT
TAACGTCCACACGGCCCCC -> AACGTCCACACGGCCCCCT
TAACTACATTGTGACTGCT -> AACTACATTGTGACTGCTG
TAACTTGAGGACTTACTTC -> AACTTGAGGACTTACTTCT
TAAGAAATGTTCTAGGGGA -> AAGAAATGTTCTAGGGGAA
TAAGAGACAGGTTCTGGTG -> AAGAGACAGGTTCTGGTGG
TAAGCGCACACCCTCCCTG -> AAGCGCACACCCTCCCTGG
TAAGTCTCAGGTGATAGAT -> AAGTCTCAGGTGATAGATT
TAAGTTCTGAAAAATGCGT -> AAGTTCTGAAAAATGCGTG
TAATACCGAGGCATAGGGC -> AATACCGAGGCATAGGGCT
TAATAGATCCGCGAAAGAA -> AATAGATCCGCGAAAGAAT
TAATCGCCGGATATTGGAT -> AATCGCCGGATATTGGATC
TAATGCGCCGACCGTGCTT -> AATGCGCCGACCGTGCTTA
TAATGTTAGCGCCCTTCAA -> AATGTTAGCGCCCTTCAAT
TAATTTCCACTCGCGTGTC -> AATTTCCACTCGCGTGTCA
TACATTGTGACTGCTGCGC -> ACATTGTGACTGCTGCGCC
TACCATATTCATAGCATCC -> ACCATATTCATAGCATCCT
TACCATGCTCGGTTTTTCC -> ACCATGCTCGGTTTTTCCT
TACCGAATAACAAAGTATG -> ACCGAATAACAAAGTATGG
TACCGAGGCATAGGGCTGG -> ACCGAGGCATAGGGCTGGC
TACCGCACGCGAACATGTT -> ACCGCACGCGAACATGTTT
TACCTTAACTTGAGGACTT -> ACCTTAACTTGAGGACTTA
TACGAACCTGTCGCATCGG -> ACGAACCTGTCGCATCGGC
TACGACGGTTAACAGTCCA -> ACGACGGTTAACAGTCCAA
TACGCCTACGGCTACTCCA -> ACGCCTACGGCTACTCCAA
TACGGACAGCTAGGGTCCA -> ACGGACAGCTAGGGTCCAA
TACGGCTACTCCAACAAAT -> ACGGCTACTCCAACAAATC
TACGGGTTAGGTTCTATCA -> ACGGGTTAGGTTCTATCAA
TACGTACTGCGAAACTCTT -> ACGTACTGCGAAACTCTTT
TACGTGACACCTAGTTCCA -> ACGTGACACCTAGTTCCAA
TACGTTCCCGTGTCGTATT -> ACGTTCCCGTGTCGTATTC
TACTCCAACAAATCTTGTG -> ACTCCAACAAATCTTGTGA
TACTCCTTTGCCACAGCTA -> ACTCCTTTGCCACAGCTAG
TACTCGGATCGACGCAGTT -> ACTCGGATCGACGCAGTTT
TACTCTTTACTTTTGTAGG -> ACTCTTTACTTTTGTAGGC
TACTGCAGGCAACCCTGGT -> ACTGCAGGCAACCCTGGTA
TACTGCGAAACTCTTTAAT -> ACTGCGAAACTCTTTAATA
TACTTATCGTTCCACCCGC -> ACTTATCGTTCCACCCGCG
TACTTCTGGTCTTATGTTA -> ACTTCTGGTCTTATGTTAG
TACTTGGAGGCACAAATGC -> ACTTGGAGGCACAAATGCG
TACTTGGTCAGTCCGGCTC -> ACTTGGTCAGTCCGGCTCT
TACTTTCTTGTTTCGGACG -> ACTTTCTTGTTTCGGACGT
TACTTTTGTAGGCCGCAGG -> ACTTTTGTAGGCCGCAGGT
TAGAAAGGCGTGAGTCGTG -> AGAAAGGCGTGAGTCGTGT
TAGAAATACTGCAGGCAAC -> AGAAATACTGCAGGCAACC
TAGAAATCGCCTGTATCAC -> AGAAATCGCCTGTATCACG
TAGAACACTATGAAACCTT -> AGAACACTATGAAACCTTA
TAGAATTAACATGATTACG -> AGAATTAACATGATTACGA
TAGAATTGTAAAGACGCAC -> AGAATTGTAAAGACGCACT
TAGACATCCGTATCCTCAA -> AGACATCCGTATCCTCAAG
TAGACCGCGCGTGGATTTG -> AGACCGCGCGTGGATTTGT
TAGATCCCGTGCAGAGTCG -> AGATCCCGTGCAGAGTCGT
TAGATCCGCGAAAGAATGC -> AGATCCGCGAAAGAATGCG
TAGATTGTTAATCGCCGGA -> AGATTGTTAATCGCCGGAT
TAGCAGCTGTGATGGCGGT -> AGCAGCTGTGATGGCGGTA
TAGCATCCTGCCTTGAATC -> AGCATCCTGCCTTGAATCG
TAGCCATTGTGAATTCGGG -> AGCCATTGTGAATTCGGGC
TAGCCGAATTTTCGGTTCC -> AGCCGAATTTTCGGTTCCT
TAGCCTTGTCGGACTAACA -> AGCCTTGTCGGACTAACAC
TAGCGAAACCAATGCTCGC -> AGCGAAACCAATGCTCGCA
TAGCGCCCTTCAATTAGCT -> AGCGCCCTTCAATTAGCTG
TAGCTGAGCAGGCCACGTT -> AGCTGAGCAGGCCACGTTC
TAGCTGTTCATCCTAGAAC -> AGCTGTTCATCCTAGAACA
TAGCTTCAACAGGGGCTTT -> AGCTTCAACAGGGGCTTTT
TAGCTTCCAACTGGCGGAA -> AGCTTCCAACTGGCGGAAC
TAGGAATAGTTGTCGTTTA -> AGGAATAGTTGTCGTTTAA
TAGGACACGAATATTTGGA -> AGGACACGAATATTTGGAT
TAGGATCCATACCGCACGC -> AGGATCCATACCGCACGCG
TAGGCCGCAGGTCGCCGGA -> AGGCCGCAGGTCGCCGGAC
TAGGCGATGTCAACATTGC -> AGGCGATGTCAACATTGCA
TAGGGCCGCCATATACGTA -> AGGGCCGCCATATACGTAC
TAGGGCTGGCTGGACGTGA -> AGGGCTGGCTGGACGTGAT
TAGGGGAATTCGGGCGTTT -> AGGGGAATTCGGGCGTTTT
TAGGGTCCAACAAATCTTG -> AGGGTCCAACAAATCTTGT
TAGGTTCTATCAATGTCGT -> AGGTTCTATCAATGTCGTC
TAGTACTTATCGTTCCACC -> AGTACTTATCGTTCCACCC
TAGTAGAATTGTAAAGACG -> AGTAGAATTGTAAAGACGC
TAGTAGGAATAGTTGTCGT -> AGTAGGAATAGTTGTCGTT
TAGTCCAGAGGTCTCCAGG -> AGTCCAGAGGTCTCCAGGG
TAGTGCCCCAAAGCCAAAC -> AGTGCCCCAAAGCCAAACC
TAGTGCTCACTCAACAGTT -> AGTGCTCACTCAACAGTTC
TAGTTCCAACAAATCTTGT -> AGTTCCAACAAATCTTGTG
TAGTTGGGGCCGAGAGCAG -> AGTTGGGGCCGAGAGCAGC
TAGTTGTCGTTTAAACGGT -> AGTTGTCGTTTAAACGGTT
TAGTTTTCCCCACATTCGT -> AGTTTTCCCCACATTCGTA
TATACGTACTGCGAAACTC -> ATACGTACTGCGAAACTCT
TATAGAATTAACATGATTA -> ATAGAATTAACATGATTAC
TATATAGAATTAACATGAT -> ATATAGAATTAACATGATT
TATCAATGTCGTCTCTGAA -> ATCAATGTCGTCTCTGAAA
TATCACGCCGCATATTTCA -> ATCACGCCGCATATTTCAA
TATCCTCAAGGGAAGTACC -> ATCCTCAAGGGAAGTACCG
TATCGGTTGAGGCGGGGGA -> ATCGGTTGAGGCGGGGGAT
TATCGTTCCACCCGCGCGA -> ATCGTTCCACCCGCGCGAT
TATGAAACCTTATGCCTAG -> ATGAAACCTTATGCCTAGA
TATGATGGCACACTACTCC -> ATGATGGCACACTACTCCT
TATGCCGGAACCACACTCC -> ATGCCGGAACCACACTCCC
TATGCCTAGAAAGGCGTGA -> ATGCCTAGAAAGGCGTGAG
TATGGTCTTGTAGTACTTA -> ATGGTCTTGTAGTACTTAT
TATGTAAAAGGAGACCATG -> ATGTAAAAGGAGACCATGC
TATGTCTGTTTTGGGTGAA -> ATGTCTGTTTTGGGTGAAA
TATGTTAGCGAAACCAATG -> ATGTTAGCGAAACCAATGC
TATGTTGCCCTCAGCTACC -> ATGTTGCCCTCAGCTACCA
TATTCAAGAACAAGGCCGA -> ATTCAAGAACAAGGCCGAG
TATTCACCCTTATTCAGAG -> ATTCACCCTTATTCAGAGA
TATTCAGAGATGTGCTCAC -> ATTCAGAGATGTGCTCACT
TATTCATAGCATCCTGCCT -> ATTCATAGCATCCTGCCTT
TATTCATCTAACTACATTG -> ATTCATCTAACTACATTGT
TATTGAGCCCGCGTCCGAC -> ATTGAGCCCGCGTCCGACC
TATTGGATCGATAGCCTTG -> ATTGGATCGATAGCCTTGT
TATTTCAATAGAAATACTG -> ATTTCAATAGAAATACTGC
TATTTCCACCCCGGAAAGG -> ATTTCCACCCCGGAAAGGC
TATTTGGATATCGGTTGAG -> ATTTGGATATCGGTTGAGG
TCAACAGGGGCTTTTACCT -> CAACAGGGGCTTTTACCTT
TCAACAGTTCTCCGAGTTC -> CAACAGTTCTCCGAGTTCC
TCAACATTGCAGTGATTCA -> CAACATTGCAGTGATTCAA
TCAACGCCCCTCGATGGTA -> CAACGCCCCTCGATGGTAT
TCAAGAACAAGGCCGAGAC -> CAAGAACAAGGCCGAGACA
TCAAGGGAAGTACCGAATA -> CAAGGGAAGTACCGAATAA
TCAATAGAAATACTGCAGG -> CAATAGAAATACTGCAGGC
TCAATCATTGGTACTTGGT -> CAATCATTGGTACTTGGTC
TCAATGTCGTCTCTGAAAA -> CAATGTCGTCTCTGAAAAC
TCAATTAGCTGAGCAGGCC -> CAATTAGCTGAGCAGGCCA
TCACCCTTATTCAGAGATG -> CACCCTTATTCAGAGATGT
TCACGAGAAGGTGTCTGAA -> CACGAGAAGGTGTCTGAAG
TCACGCCGCATATTTCAAT -> CACGCCGCATATTTCAATA
TCACGTGGGAACTAGTAGA -> CACGTGGGAACTAGTAGAA
TCACGTTTTAGGCGATGTC -> CACGTTTTAGGCGATGTCA
TCACTCAACAGTTCTCCGA -> CACTCAACAGTTCTCCGAG
TCACTCACGTGGGAACTAG -> CACTCACGTGGGAACTAGT
TCACTGGTAGTCCAGAGGT -> CACTGGTAGTCCAGAGGTC
TCAGAGATGTGCTCACTCA -> CAGAGATGTGCTCACTCAC
TCAGCTACCATGCTCGGTT -> CAGCTACCATGCTCGGTTT
TCAGGACGATTCGACCCAC -> CAGGACGATTCGACCCACA
TCAGGTGATAGATTGTTAA -> CAGGTGATAGATTGTTAAT
TCAGTCCGGCTCTGGAGTG -> CAGTCCGGCTCTGGAGTGT
TCATAGCATCCTGCCTTGA -> CATAGCATCCTGCCTTGAA
TCATATTCAAGAACAAGGC -> CATATTCAAGAACAAGGCC
TCATCCTAGAACACTATGA -> CATCCTAGAACACTATGAA
TCATCTAACTACATTGTGA -> CATCTAACTACATTGTGAC
TCATGAGTCGGTCTTTTGC -> CATGAGTCGGTCTTTTGCA
TCATTGGTACTTGGTCAGT -> CATTGGTACTTGGTCAGTC
TCCAAAACATCTATGTCTG -> CCAAAACATCTATGTCTGT
TCCAAACGTCAACGCCCCT -> CCAAACGTCAACGCCCCTC
TCCAACAAATCTTGTGAGC -> CCAACAAATCTTGTGAGCA,CCAACAAATCTTGTGAGCC,CCAACAAATCTTGTGAGCG,CCAACAAATCTTGTGAGCT
TCCAACTGGCGGAACGCGC -> CCAACTGGCGGAACGCGCT
TCCAATCTGGAGTAATGCA -> CCAATCTGGAGTAATGCAA
TCCACACGGCCCCCTGTAG -> CCACACGGCCCCCTGTAGT
TCCACCCCGGAAAGGCACT -> CCACCCCGGAAAGGCACTA
TCCACCCGCGCGATCGTTT -> CCACCCGCGCGATCGTTTC
TCCACTCGCGTGTCACGTT -> CCACTCGCGTGTCACGTTT
TCCAGAGGTCTCCAGGGCA -> CCAGAGGTCTCCAGGGCAA
TCCAGCGCTAATGCGCCGA -> CCAGCGCTAATGCGCCGAC
TCCAGGGCAAGAGCCAAAG -> CCAGGGCAAGAGCCAAAGG
TCCAGGTGCCAAGTAGCTT -> CCAGGTGCCAAGTAGCTTC
TCCATACCGCACGCGAACA -> CCATACCGCACGCGAACAT
TCCATGACCTGTTGCTATG -> CCATGACCTGTTGCTATGA
TCCATTGCGTCCTCTGCTT -> CCATTGCGTCCTCTGCTTT
TCCCCACATTCGTAGGGCC -> CCCCACATTCGTAGGGCCG
TCCCCGATCCATTGCGTCC -> CCCCGATCCATTGCGTCCT
TCCCCTGGCACCGTTCCAG -> CCCCTGGCACCGTTCCAGC
TCCCGCCCACTAGACCGCG -> CCCGCCCACTAGACCGCGC
TCCCGTCTCGGAAATTTCT -> CCCGTCTCGGAAATTTCTT
TCCCGTGCAGAGTCGTCTA -> CCCGTGCAGAGTCGTCTAG
TCCCGTGTCGTATTCATCT -> CCCGTGTCGTATTCATCTA
TCCCTGGAATCTTACTCTT -> CCCTGGAATCTTACTCTTT
TCCGACCTCGCAGGGGGAC -> CCGACCTCGCAGGGGGACC
TCCGAGTTCCAAACGTCAA -> CCGAGTTCCAAACGTCAAC
TCCGCGAAAGAATGCGTTG -> CCGCGAAAGAATGCGTTGC
TCCGCGCCGTCCATGACCT -> CCGCGCCGTCCATGACCTG
TCCGGCTCTGGAGTGTACG -> CCGGCTCTGGAGTGTACGG
TCCGGTAGTTTTCCCCACA -> CCGGTAGTTTTCCCCACAT
TCCGTATCCTCAAGGGAAG -> CCGTATCCTCAAGGGAAGT
TCCGTTCCAGGTGCCAAGT -> CCGTTCCAGGTGCCAAGTA
TCCTACTCGGATCGACGCA -> CCTACTCGGATCGACGCAG
TCCTAGAACACTATGAAAC -> CCTAGAACACTATGAAACC
TCCTCAAGGGAAGTACCGA -> CCTCAAGGGAAGTACCGAA
TCCTCCTACTCGGATCGAC -> CCTCCTACTCGGATCGACG
TCCTCGCGTCATATTCAAG -> CCTCGCGTCATATTCAAGA
TCCTCTGCTTTGCTCTCCG -> CCTCTGCTTTGCTCTCCGC
TCCTGCCTTGAATCGCACA -> CCTGCCTTGAATCGCACAT
TCCTTTGCCACAGCTAGTA -> CCTTTGCCACAGCTAGTAG
TCGAATTCGGGCGTTTTAC -> CGAATTCGGGCGTTTTACG
TCGACCCACAATAATGTTA -> CGACCCACAATAATGTTAG
TCGACGCAGTTTGGGAGCC -> CGACGCAGTTTGGGAGCCT
TCGATAGCCTTGTCGGACT -> CGATAGCCTTGTCGGACTA
TCGATGGTATATAGAATTA -> CGATGGTATATAGAATTAA
TCGATTAAGTTCTGAAAAA -> CGATTAAGTTCTGAAAAAT
TCGCACATTAAAGGTGGAT -> CGCACATTAAAGGTGGATG
TCGCAGAGAACTCGCTGCC -> CGCAGAGAACTCGCTGCCC
TCGCAGGGGGACCTTTTGT -> CGCAGGGGGACCTTTTGTA
TCGCATCGGCCGGACAGCC -> CGCATCGGCCGGACAGCCT
TCGCCGGACTGTCCAAAAC -> CGCCGGACTGTCCAAAACA
TCGCCGGATATTGGATCGA -> CGCCGGATATTGGATCGAT
TCGCCTGTATCACGCCGCA -> CGCCTGTATCACGCCGCAT
TCGCGTCATATTCAAGAAC -> CGCGTCATATTCAAGAACA
TCGCGTGTCACGTTTTAGG -> CGCGTGTCACGTTTTAGGC
TCGCTGCCCCGACTAATTT -> CGCTGCCCCGACTAATTTC
TCGGAAATTTCTTCATGAG -> CGGAAATTTCTTCATGAGT
TCGGACGTAACGTCCACAC -> CGGACGTAACGTCCACACG
TCGGACTAACACGTTATGT -> CGGACTAACACGTTATGTA
TCGGATCGACGCAGTTTGG -> CGGATCGACGCAGTTTGGG
TCGGCCGGACAGCCTGGCA -> CGGCCGGACAGCCTGGCAC
TCGGGCGTTTTACGACGGT -> CGGGCGTTTTACGACGGTT
TCGGGCGTTTTACGCCTAC -> CGGGCGTTTTACGCCTACG
TCGGGCGTTTTACGGACAG -> CGGGCGTTTTACGGACAGC
TCGGGCGTTTTACGTGACA -> CGGGCGTTTTACGTGACAC
TCGGGCTTGACGAAAACAC -> CGGGCTTGACGAAAACACG
TCGGTCTTTTGCACAGGAT -> CGGTCTTTTGCACAGGATC
TCGGTTCCTCCTACTCGGA -> CGGTTCCTCCTACTCGGAT
TCGGTTGAGGCGGGGGATT -> CGGTTGAGGCGGGGGATTC
TCGGTTTTTCCTCGCGTCA -> CGGTTTTTCCTCGCGTCAT
TCGTAGGGCCGCCATATAC -> CGTAGGGCCGCCATATACG
TCGTATTCATCTAACTACA -> CGTATTCATCTAACTACAT
TCGTCTAGCTTCAACAGGG -> CGTCTAGCTTCAACAGGGG
TCGTCTCTGAAAACCTTAC -> CGTCTCTGAAAACCTTACT
TCGTGTCCCGTCTCGGAAA -> CGTGTCCCGTCTCGGAAAT
TCGTTAGACATCCGTATCC -> CGTTAGACATCCGTATCCT
TCGTTCCACCCGCGCGATC -> CGTTCCACCCGCGCGATCG
TCGTTTAAACGGTTCTGAA -> CGTTTAAACGGTTCTGAAA
TCGTTTCCGGTAGTTTTCC -> CGTTTCCGGTAGTTTTCCC
TCTAACTACATTGTGACTG -> CTAACTACATTGTGACTGC
TCTAGATCCCGTGCAGAGT -> CTAGATCCCGTGCAGAGTC
TCTAGCTTCAACAGGGGCT -> CTAGCTTCAACAGGGGCTT
TCTAGGGGAATTCGGGCGT -> CTAGGGGAATTCGGGCGTT
TCTATCAATGTCGTCTCTG -> CTATCAATGTCGTCTCTGA
TCTATGTCTGTTTTGGGTG -> CTATGTCTGTTTTGGGTGA
TCTATGTTGCCCTCAGCTA -> CTATGTTGCCCTCAGCTAC
TCTCAGGTGATAGATTGTT -> CTCAGGTGATAGATTGTTA
TCTCCAGGGCAAGAGCCAA -> CTCCAGGGCAAGAGCCAAA
TCTCCCGCCCACTAGACCG -> CTCCCGCCCACTAGACCGC
TCTCCGAGTTCCAAACGTC -> CTCCGAGTTCCAAACGTCA
TCTCCGCGCCGTCCATGAC -> CTCCGCGCCGTCCATGACC
TCTCGAATTCGGGCGTTTT -> CTCGAATTCGGGCGTTTTA
TCTCGGAAATTTCTTCATG -> CTCGGAAATTTCTTCATGA
TCTCTGAAAACCTTACTTG -> CTCTGAAAACCTTACTTGG
TCTGAAAAATGCGTGTCTC -> CTGAAAAATGCGTGTCTCG
TCTGAAAACCTTACTTGGA -> CTGAAAACCTTACTTGGAG
TCTGAAATAAGAGACAGGT -> CTGAAATAAGAGACAGGTT
TCTGAAGAATTCGGGCGTT -> CTGAAGAATTCGGGCGTTT
TCTGCTTTGCTCTCCGCGC -> CTGCTTTGCTCTCCGCGCC
TCTGGAGTGTACGGGTTAG -> CTGGAGTGTACGGGTTAGG
TCTGGTCTTATGTTAGCGA -> CTGGTCTTATGTTAGCGAA
TCTGGTGGCCGGGCGGGAA -> CTGGTGGCCGGGCGGGAAT
TCTGTGCCCTCTAGATCCC -> CTGTGCCCTCTAGATCCCG
TCTGTTTTGGGTGAAAACT -> CTGTTTTGGGTGAAAACTA
TCTTACTCTTTACTTTTGT -> CTTACTCTTTACTTTTGTA
TCTTATGTTAGCGAAACCA -> CTTATGTTAGCGAAACCAA
TCTTCATGAGTCGGTCTTT -> CTTCATGAGTCGGTCTTTT
TCTTGTAGTACTTATCGTT -> CTTGTAGTACTTATCGTTC
TCTTGTGAGCATGGGTTAG -> CTTGTGAGCATGGGTTAGT
TCTTGTGAGCCAGTTGTAG -> CTTGTGAGCCAGTTGTAGC
TCTTGTGAGCGGATTTGTC -> CTTGTGAGCGGATTTGTCA
TCTTGTGAGCTTGTTGTTT -> CTTGTGAGCTTGTTGTTTT
TCTTGTTTCGGACGTAACG -> CTTGTTTCGGACGTAACGT
TCTTTAATAGATCCGCGAA -> CTTTAATAGATCCGCGAAA
TCTTTACTTTTGTAGGCCG -> CTTTACTTTTGTAGGCCGC
TCTTTCTATGTTGCCCTCA -> CTTTCTATGTTGCCCTCAG
TCTTTTGCACAGGATCAGG -> CTTTTGCACAGGATCAGGA
TGAAAAATGCGTGTCTCGA -> GAAAAATGCGTGTCTCGAA
TGAAAACCTTACTTGGAGG -> GAAAACCTTACTTGGAGGC
TGAAAACTAAAAAATATTT -> GAAAACTAAAAAATATTTC
TGAAACCTTATGCCTAGAA -> GAAACCTTATGCCTAGAAA
TGAAATAAGAGACAGGTTC -> GAAATAAGAGACAGGTTCT
TGAAGAATTCGGGCGTTTT -> GAAGAATTCGGGCGTTTTA
TGAATCGCACATTAAAGGT -> GAATCGCACATTAAAGGTG
TGAATTCGGGCGTTTTACG -> GAATTCGGGCGTTTTACGT
TGACACCTAGTTCCAACAA -> GACACCTAGTTCCAACAAA
TGACCTGTTGCTATGATGG -> GACCTGTTGCTATGATGGC
TGACGAAAACACGCTGTAA -> GACGAAAACACGCTGTAAG
TGACTGCTGCGCCCTTAGC -> GACTGCTGCGCCCTTAGCA
TGAGCAGGCCACGTTCCCC -> GAGCAGGCCACGTTCCCCT
TGAGCATGGGTTAGTTGGG -> GAGCATGGGTTAGTTGGGG
TGAGCCAGTTGTAGCTGTT -> GAGCCAGTTGTAGCTGTTC
TGAGCCCGCGTCCGACCTC -> GAGCCCGCGTCCGACCTCG
TGAGCGGATTTGTCACTGG -> GAGCGGATTTGTCACTGGT
TGAGCTTGTTGTTTTACCA -> GAGCTTGTTGTTTTACCAT
TGAGGACTTACTTCTGGTC -> GAGGACTTACTTCTGGTCT
TGAGGCGGGGGATTCTCCC -> GAGGCGGGGGATTCTCCCG
TGAGTCGGTCTTTTGCACA -> GAGTCGGTCTTTTGCACAG
TGAGTCGTGTCCCGTCTCG -> GAGTCGTGTCCCGTCTCGG
TGAGTTCGGGCTTGACGAA -> GAGTTCGGGCTTGACGAAA
TGATAGATTGTTAATCGCC -> GATAGATTGTTAATCGCCG
TGATGGACAACTTATTGAG -> GATGGACAACTTATTGAGC
TGATGGCACACTACTCCTT -> GATGGCACACTACTCCTTT
TGATGGCGGTATGCCGGAA -> GATGGCGGTATGCCGGAAC
TGATTACGAACCTGTCGCA -> GATTACGAACCTGTCGCAT
TGATTCAATCATTGGTACT -> GATTCAATCATTGGTACTT
TGCACAGGATCAGGACGAT -> GCACAGGATCAGGACGATT
TGCAGAGTCGTCTAGCTTC -> GCAGAGTCGTCTAGCTTCA
TGCAGGCAACCCTGGTAGT -> GCAGGCAACCCTGGTAGTG
TGCAGTGATTCAATCATTG -> GCAGTGATTCAATCATTGG
TGCCAAGTAGCTTCCAACT -> GCCAAGTAGCTTCCAACTG
TGCCACAGCTAGTAGGAAT -> GCCACAGCTAGTAGGAATA
TGCCCCAAAGCCAAACCTA -> GCCCCAAAGCCAAACCTAC
TGCCCCGACTAATTTCCAC -> GCCCCGACTAATTTCCACT
TGCCCTCAGCTACCATGCT -> GCCCTCAGCTACCATGCTC
TGCCCTCTAGATCCCGTGC -> GCCCTCTAGATCCCGTGCA
TGCCGGAACCACACTCCCC -> GCCGGAACCACACTCCCCG
TGCCTAGAAAGGCGTGAGT -> GCCTAGAAAGGCGTGAGTC
TGCCTTGAATCGCACATTA -> GCCTTGAATCGCACATTAA
TGCGAAACTCTTTAATAGA -> GCGAAACTCTTTAATAGAT
TGCGCCACGTGTAGGACAC -> GCGCCACGTGTAGGACACG
TGCGCCCTTAGCAGCTGTG -> GCGCCCTTAGCAGCTGTGA
TGCGCCGACCGTGCTTAAG -> GCGCCGACCGTGCTTAAGA
TGCGTCCTCTGCTTTGCTC -> GCGTCCTCTGCTTTGCTCT
TGCGTGTCTCGAATTCGGG -> GCGTGTCTCGAATTCGGGC
TGCGTTGCTAAGCGCACAC -> GCGTTGCTAAGCGCACACC
TGCTAAGCGCACACCCTCC -> GCTAAGCGCACACCCTCCC
TGCTATGATGGCACACTAC -> GCTATGATGGCACACTACT
TGCTCACTCAACAGTTCTC -> GCTCACTCAACAGTTCTCC
TGCTCACTCACGTGGGAAC -> GCTCACTCACGTGGGAACT
TGCTCGCAGAGAACTCGCT -> GCTCGCAGAGAACTCGCTG
TGCTCGGTTTTTCCTCGCG -> GCTCGGTTTTTCCTCGCGT
TGCTCTCCGCGCCGTCCAT -> GCTCTCCGCGCCGTCCATG
TGCTCTTTCTATGTTGCCC -> GCTCTTTCTATGTTGCCCT
TGCTGCGCCCTTAGCAGCT -> GCTGCGCCCTTAGCAGCTG
TGCTTAAGAAATGTTCTAG -> GCTTAAGAAATGTTCTAGG
TGCTTTGCTCTCCGCGCCG -> GCTTTGCTCTCCGCGCCGT
TGGAATCTTACTCTTTACT -> GGAATCTTACTCTTTACTT
TGGACAACTTATTGAGCCC -> GGACAACTTATTGAGCCCG
TGGACGTGATGGACAACTT -> GGACGTGATGGACAACTTA
TGGAGGCACAAATGCGCCA -> GGAGGCACAAATGCGCCAC
TGGAGTGTACGGGTTAGGT -> GGAGTGTACGGGTTAGGTT
TGGATATCGGTTGAGGCGG -> GGATATCGGTTGAGGCGGG
TGGATCGATAGCCTTGTCG -> GGATCGATAGCCTTGTCGG
TGGATGAGTTCGGGCTTGA -> GGATGAGTTCGGGCTTGAC
TGGATTTGTTAGAAATCGC -> GGATTTGTTAGAAATCGCC
TGGCACACTACTCCTTTGC -> GGCACACTACTCCTTTGCC
TGGCACCGTTCCAGCGCTA -> GGCACCGTTCCAGCGCTAA
TGGCACTAGGATCCATACC -> GGCACTAGGATCCATACCG
TGGCCGGGCGGGAATAGCC -> GGCCGGGCGGGAATAGCCA
TGGCGGAACGCGCTTTTGT -> GGCGGAACGCGCTTTTGTA
TGGCGGTATGCCGGAACCA -> GGCGGTATGCCGGAACCAC
TGGCTGGACGTGATGGACA -> GGCTGGACGTGATGGACAA
TGGGAACTAGTAGAATTGT -> GGGAACTAGTAGAATTGTA
TGGGAGCCTTCGTTAGACA -> GGGAGCCTTCGTTAGACAT
TGGGGCCGAGAGCAGCCAT -> GGGGCCGAGAGCAGCCATA
TGGGTGAAAACTAAAAAAT -> GGGTGAAAACTAAAAAATA
TGGGTTAGTTGGGGCCGAG -> GGGTTAGTTGGGGCCGAGA
TGGTACTTGGTCAGTCCGG -> GGTACTTGGTCAGTCCGGC
TGGTAGTCCAGAGGTCTCC -> GGTAGTCCAGAGGTCTCCA
TGGTAGTGCCCCAAAGCCA -> GGTAGTGCCCCAAAGCCAA
TGGTATATAGAATTAACAT -> GGTATATAGAATTAACATG
TGGTCAGTCCGGCTCTGGA -> GGTCAGTCCGGCTCTGGAG
TGGTCTTATGTTAGCGAAA -> GGTCTTATGTTAGCGAAAC
TGGTCTTGTAGTACTTATC -> GGTCTTGTAGTACTTATCG
TGGTGGCCGGGCGGGAATA -> GGTGGCCGGGCGGGAATAG
TGTAAAAGGAGACCATGCT -> GTAAAAGGAGACCATGCTC
TGTAAAGACGCACTCCAAT -> GTAAAGACGCACTCCAATC
TGTAAGTCTCAGGTGATAG -> GTAAGTCTCAGGTGATAGA
TGTACGGGTTAGGTTCTAT -> GTACGGGTTAGGTTCTATC
TGTACGTTCCCGTGTCGTA -> GTACGTTCCCGTGTCGTAT
TGTAGCCGAATTTTCGGTT -> GTAGCCGAATTTTCGGTTC
TGTAGCTGTTCATCCTAGA -> GTAGCTGTTCATCCTAGAA
TGTAGGACACGAATATTTG -> GTAGGACACGAATATTTGG
TGTAGGCCGCAGGTCGCCG -> GTAGGCCGCAGGTCGCCGG
TGTAGTACTTATCGTTCCA -> GTAGTACTTATCGTTCCAC
TGTAGTGCTCACTCAACAG -> GTAGTGCTCACTCAACAGT
TGTATCACGCCGCATATTT -> GTATCACGCCGCATATTTC
TGTCAACATTGCAGTGATT -> GTCAACATTGCAGTGATTC
TGTCACGTTTTAGGCGATG -> GTCACGTTTTAGGCGATGT
TGTCACTGGTAGTCCAGAG -> GTCACTGGTAGTCCAGAGG
TGTCCAAAACATCTATGTC -> GTCCAAAACATCTATGTCT
TGTCCCGTCTCGGAAATTT -> GTCCCGTCTCGGAAATTTC
TGTCGCATCGGCCGGACAG -> GTCGCATCGGCCGGACAGC
TGTCGGACTAACACGTTAT -> GTCGGACTAACACGTTATG
TGTCGTATTCATCTAACTA -> GTCGTATTCATCTAACTAC
TGTCGTCTCTGAAAACCTT -> GTCGTCTCTGAAAACCTTA
TGTCGTTTAAACGGTTCTG -> GTCGTTTAAACGGTTCTGA
TGTCTCGAATTCGGGCGTT -> GTCTCGAATTCGGGCGTTT
TGTCTGAAGAATTCGGGCG -> GTCTGAAGAATTCGGGCGT
TGTCTGTGCCCTCTAGATC -> GTCTGTGCCCTCTAGATCC
TGTCTGTTTTGGGTGAAAA -> GTCTGTTTTGGGTGAAAAC
TGTGAATTCGGGCGTTTTA -> GTGAATTCGGGCGTTTTAC
TGTGACTGCTGCGCCCTTA -> GTGACTGCTGCGCCCTTAG
TGTGAGCATGGGTTAGTTG -> GTGAGCATGGGTTAGTTGG
TGTGAGCCAGTTGTAGCTG -> GTGAGCCAGTTGTAGCTGT
TGTGAGCGGATTTGTCACT -> GTGAGCGGATTTGTCACTG
TGTGAGCTTGTTGTTTTAC -> GTGAGCTTGTTGTTTTACC
TGTGATGGCGGTATGCCGG -> GTGATGGCGGTATGCCGGA
TGTGCCCTCTAGATCCCGT -> GTGCCCTCTAGATCCCGTG
TGTGCTCACTCACGTGGGA -> GTGCTCACTCACGTGGGAA
TGTTAATCGCCGGATATTG -> GTTAATCGCCGGATATTGG
TGTTAGAAATCGCCTGTAT -> GTTAGAAATCGCCTGTATC
TGTTAGCGAAACCAATGCT -> GTTAGCGAAACCAATGCTC
TGTTAGCGCCCTTCAATTA -> GTTAGCGCCCTTCAATTAG
TGTTCATCCTAGAACACTA -> GTTCATCCTAGAACACTAT
TGTTCTAGGGGAATTCGGG -> GTTCTAGGGGAATTCGGGC
TGTTGCCCTCAGCTACCAT -> GTTGCCCTCAGCTACCATG
TGTTGCTATGATGGCACAC -> GTTGCTATGATGGCACACT
TGTTGTTTTACCATATTCA -> GTTGTTTTACCATATTCAT
TGTTTCGATTAAGTTCTGA -> GTTTCGATTAAGTTCTGAA
TGTTTCGGACGTAACGTCC -> GTTTCGGACGTAACGTCCA
TGTTTTACCATATTCATAG -> GTTTTACCATATTCATAGC
TGTTTTGGGTGAAAACTAA -> GTTTTGGGTGAAAACTAAA
TTAAACGGTTCTGAAATAA -> TAAACGGTTCTGAAATAAG
TTAAAGGTGGATGAGTTCG -> TAAAGGTGGATGAGTTCGG
TTAACAGTCCAACAAATCT -> TAACAGTCCAACAAATCTT
TTAACATGATTACGAACCT -> TAACATGATTACGAACCTG
TTAACTTGAGGACTTACTT -> TAACTTGAGGACTTACTTC
TTAAGAAATGTTCTAGGGG -> TAAGAAATGTTCTAGGGGA
TTAAGTTCTGAAAAATGCG -> TAAGTTCTGAAAAATGCGT
TTAATAGATCCGCGAAAGA -> TAATAGATCCGCGAAAGAA
TTAATCGCCGGATATTGGA -> TAATCGCCGGATATTGGAT
TTACCATATTCATAGCATC -> TACCATATTCATAGCATCC
TTACCTTAACTTGAGGACT -> TACCTTAACTTGAGGACTT
TTACGAACCTGTCGCATCG -> TACGAACCTGTCGCATCGG
TTACGACGGTTAACAGTCC -> TACGACGGTTAACAGTCCA
TTACGCCTACGGCTACTCC -> TACGCCTACGGCTACTCCA
TTACGGACAGCTAGGGTCC -> TACGGACAGCTAGGGTCCA
TTACGTGACACCTAGTTCC -> TACGTGACACCTAGTTCCA
TTACTCTTTACTTTTGTAG -> TACTCTTTACTTTTGTAGG
TTACTTCTGGTCTTATGTT -> TACTTCTGGTCTTATGTTA
TTACTTGGAGGCACAAATG -> TACTTGGAGGCACAAATGC
TTACTTTTGTAGGCCGCAG -> TACTTTTGTAGGCCGCAGG
TTAGAAATCGCCTGTATCA -> TAGAAATCGCCTGTATCAC
TTAGACATCCGTATCCTCA -> TAGACATCCGTATCCTCAA
TTAGCAGCTGTGATGGCGG -> TAGCAGCTGTGATGGCGGT
TTAGCGAAACCAATGCTCG -> TAGCGAAACCAATGCTCGC
TTAGCGCCCTTCAATTAGC -> TAGCGCCCTTCAATTAGCT
TTAGCTGAGCAGGCCACGT -> TAGCTGAGCAGGCCACGTT
TTAGGCGATGTCAACATTG -> TAGGCGATGTCAACATTGC
TTAGGTTCTATCAATGTCG -> TAGGTTCTATCAATGTCGT
TTAGTTGGGGCCGAGAGCA -> TAGTTGGGGCCGAGAGCAG
TTATCGTTCCACCCGCGCG -> TATCGTTCCACCCGCGCGA
TTATGCCTAGAAAGGCGTG -> TATGCCTAGAAAGGCGTGA
TTATGTAAAAGGAGACCAT -> TATGTAAAAGGAGACCATG
TTATGTTAGCGAAACCAAT -> TATGTTAGCGAAACCAATG
TTATTCAGAGATGTGCTCA -> TATTCAGAGATGTGCTCAC
TTATTGAGCCCGCGTCCGA -> TATTGAGCCCGCGTCCGAC
TTCAACAGGGGCTTTTACC -> TCAACAGGGGCTTTTACCT
TTCAAGAACAAGGCCGAGA -> TCAAGAACAAGGCCGAGAC
TTCAATAGAAATACTGCAG -> TCAATAGAAATACTGCAGG
TTCAATCATTGGTACTTGG -> TCAATCATTGGTACTTGGT
TTCAATTAGCTGAGCAGGC -> TCAATTAGCTGAGCAGGCC
TTCACCCTTATTCAGAGAT -> TCACCCTTATTCAGAGATG
TTCAGAGATGTGCTCACTC -> TCAGAGATGTGCTCACTCA
TTCATAGCATCCTGCCTTG -> TCATAGCATCCTGCCTTGA
TTCATCCTAGAACACTATG -> TCATCCTAGAACACTATGA
TTCATCTAACTACATTGTG -> TCATCTAACTACATTGTGA
TTCATGAGTCGGTCTTTTG -> TCATGAGTCGGTCTTTTGC
TTCCAAACGTCAACGCCCC -> TCCAAACGTCAACGCCCCT
TTCCAACAAATCTTGTGAG -> TCCAACAAATCTTGTGAGC
TTCCAACTGGCGGAACGCG -> TCCAACTGGCGGAACGCGC
TTCCACCCCGGAAAGGCAC -> TCCACCCCGGAAAGGCACT
TTCCACCCGCGCGATCGTT -> TCCACCCGCGCGATCGTTT
TTCCACTCGCGTGTCACGT -> TCCACTCGCGTGTCACGTT
TTCCAGCGCTAATGCGCCG -> TCCAGCGCTAATGCGCCGA
TTCCAGGTGCCAAGTAGCT -> TCCAGGTGCCAAGTAGCTT
TTCCCCACATTCGTAGGGC -> TCCCCACATTCGTAGGGCC
TTCCCCTGGCACCGTTCCA -> TCCCCTGGCACCGTTCCAG
TTCCCGTGTCGTATTCATC -> TCCCGTGTCGTATTCATCT
TTCCGGTAGTTTTCCCCAC -> TCCGGTAGTTTTCCCCACA
TTCCGTTCCAGGTGCCAAG -> TCCGTTCCAGGTGCCAAGT
TTCCTCCTACTCGGATCGA -> TCCTCCTACTCGGATCGAC
TTCCTCGCGTCATATTCAA -> TCCTCGCGTCATATTCAAG
TTCGACCCACAATAATGTT -> TCGACCCACAATAATGTTA
TTCGATTAAGTTCTGAAAA -> TCGATTAAGTTCTGAAAAA
TTCGGACGTAACGTCCACA -> TCGGACGTAACGTCCACAC
TTCGGGCGTTTTACGACGG -> TCGGGCGTTTTACGACGGT
TTCGGGCGTTTTACGCCTA -> TCGGGCGTTTTACGCCTAC
TTCGGGCGTTTTACGGACA -> TCGGGCGTTTTACGGACAG
TTCGGGCGTTTTACGTGAC -> TCGGGCGTTTTACGTGACA
TTCGGGCTTGACGAAAACA -> TCGGGCTTGACGAAAACAC
TTCGGTTCCTCCTACTCGG -> TCGGTTCCTCCTACTCGGA
TTCGTAGGGCCGCCATATA -> TCGTAGGGCCGCCATATAC
TTCGTTAGACATCCGTATC -> TCGTTAGACATCCGTATCC
TTCTAGGGGAATTCGGGCG -> TCTAGGGGAATTCGGGCGT
TTCTATCAATGTCGTCTCT -> TCTATCAATGTCGTCTCTG
TTCTATGTTGCCCTCAGCT -> TCTATGTTGCCCTCAGCTA
TTCTCCCGCCCACTAGACC -> TCTCCCGCCCACTAGACCG
TTCTCCGAGTTCCAAACGT -> TCTCCGAGTTCCAAACGTC
TTCTGAAAAATGCGTGTCT -> TCTGAAAAATGCGTGTCTC
TTCTGAAATAAGAGACAGG -> TCTGAAATAAGAGACAGGT
TTCTGGTCTTATGTTAGCG -> TCTGGTCTTATGTTAGCGA
TTCTGGTGGCCGGGCGGGA -> TCTGGTGGCCGGGCGGGAA
TTCTTCATGAGTCGGTCTT -> TCTTCATGAGTCGGTCTTT
TTCTTGTTTCGGACGTAAC -> TCTTGTTTCGGACGTAACG
TTGAATCGCACATTAAAGG -> TGAATCGCACATTAAAGGT
TTGACGAAAACACGCTGTA -> TGACGAAAACACGCTGTAA
TTGAGCCCGCGTCCGACCT -> TGAGCCCGCGTCCGACCTC
TTGAGGACTTACTTCTGGT -> TGAGGACTTACTTCTGGTC
TTGAGGCGGGGGATTCTCC -> TGAGGCGGGGGATTCTCCC
TTGCACAGGATCAGGACGA -> TGCACAGGATCAGGACGAT
TTGCAGTGATTCAATCATT -> TGCAGTGATTCAATCATTG
TTGCCACAGCTAGTAGGAA -> TGCCACAGCTAGTAGGAAT
TTGCCCTCAGCTACCATGC -> TGCCCTCAGCTACCATGCT
TTGCGTCCTCTGCTTTGCT -> TGCGTCCTCTGCTTTGCTC
TTGCTAAGCGCACACCCTC -> TGCTAAGCGCACACCCTCC
TTGCTATGATGGCACACTA -> TGCTATGATGGCACACTAC
TTGCTCTCCGCGCCGTCCA -> TGCTCTCCGCGCCGTCCAT
TTGGAGGCACAAATGCGCC -> TGGAGGCACAAATGCGCCA
TTGGATATCGGTTGAGGCG -> TGGATATCGGTTGAGGCGG
TTGGATCGATAGCCTTGTC -> TGGATCGATAGCCTTGTCG
TTGGGAGCCTTCGTTAGAC -> TGGGAGCCTTCGTTAGACA
TTGGGGCCGAGAGCAGCCA -> TGGGGCCGAGAGCAGCCAT
TTGGGTGAAAACTAAAAAA -> TGGGTGAAAACTAAAAAAT
TTGGTACTTGGTCAGTCCG -> TGGTACTTGGTCAGTCCGG
TTGGTCAGTCCGGCTCTGG -> TGGTCAGTCCGGCTCTGGA
TTGTAAAGACGCACTCCAA -> TGTAAAGACGCACTCCAAT
TTGTACGTTCCCGTGTCGT -> TGTACGTTCCCGTGTCGTA
TTGTAGCCGAATTTTCGGT -> TGTAGCCGAATTTTCGGTT
TTGTAGCTGTTCATCCTAG -> TGTAGCTGTTCATCCTAGA
TTGTAGGCCGCAGGTCGCC -> TGTAGGCCGCAGGTCGCCG
TTGTAGTACTTATCGTTCC -> TGTAGTACTTATCGTTCCA
TTGTCACTGGTAGTCCAGA -> TGTCACTGGTAGTCCAGAG
TTGTCGGACTAACACGTTA -> TGTCGGACTAACACGTTAT
TTGTCGTTTAAACGGTTCT -> TGTCGTTTAAACGGTTCTG
TTGTCTGTGCCCTCTAGAT -> TGTCTGTGCCCTCTAGATC
TTGTGAATTCGGGCGTTTT -> TGTGAATTCGGGCGTTTTA
TTGTGACTGCTGCGCCCTT -> TGTGACTGCTGCGCCCTTA
TTGTGAGCATGGGTTAGTT -> TGTGAGCATGGGTTAGTTG
TTGTGAGCCAGTTGTAGCT -> TGTGAGCCAGTTGTAGCTG
TTGTGAGCGGATTTGTCAC -> TGTGAGCGGATTTGTCACT
TTGTGAGCTTGTTGTTTTA -> TGTGAGCTTGTTGTTTTAC
TTGTTAATCGCCGGATATT -> TGTTAATCGCCGGATATTG
TTGTTAGAAATCGCCTGTA -> TGTTAGAAATCGCCTGTAT
TTGTTGTTTTACCATATTC -> TGTTGTTTTACCATATTCA
TTGTTTCGGACGTAACGTC -> TGTTTCGGACGTAACGTCC
TTGTTTTACCATATTCATA -> TGTTTTACCATATTCATAG
TTTAAACGGTTCTGAAATA -> TTAAACGGTTCTGAAATAA
TTTAATAGATCCGCGAAAG -> TTAATAGATCCGCGAAAGA
TTTACCATATTCATAGCAT -> TTACCATATTCATAGCATC
TTTACCTTAACTTGAGGAC -> TTACCTTAACTTGAGGACT
TTTACGACGGTTAACAGTC -> TTACGACGGTTAACAGTCC
TTTACGCCTACGGCTACTC -> TTACGCCTACGGCTACTCC
TTTACGGACAGCTAGGGTC -> TTACGGACAGCTAGGGTCC
TTTACGTGACACCTAGTTC -> TTACGTGACACCTAGTTCC
TTTACTTTTGTAGGCCGCA -> TTACTTTTGTAGGCCGCAG
TTTAGGCGATGTCAACATT -> TTAGGCGATGTCAACATTG
TTTCAATAGAAATACTGCA -> TTCAATAGAAATACTGCAG
TTTCCACCCCGGAAAGGCA -> TTCCACCCCGGAAAGGCAC
TTTCCACTCGCGTGTCACG -> TTCCACTCGCGTGTCACGT
TTTCCCCACATTCGTAGGG -> TTCCCCACATTCGTAGGGC
TTTCCGGTAGTTTTCCCCA -> TTCCGGTAGTTTTCCCCAC
TTTCCTCGCGTCATATTCA -> TTCCTCGCGTCATATTCAA
TTTCGATTAAGTTCTGAAA -> TTCGATTAAGTTCTGAAAA
TTTCGGACGTAACGTCCAC -> TTCGGACGTAACGTCCACA
TTTCGGTTCCTCCTACTCG -> TTCGGTTCCTCCTACTCGG
TTTCTATGTTGCCCTCAGC -> TTCTATGTTGCCCTCAGCT
TTTCTTCATGAGTCGGTCT -> TTCTTCATGAGTCGGTCTT
TTTCTTGTTTCGGACGTAA -> TTCTTGTTTCGGACGTAAC
TTTGCACAGGATCAGGACG -> TTGCACAGGATCAGGACGA
TTTGCCACAGCTAGTAGGA -> TTGCCACAGCTAGTAGGAA
TTTGCTCTCCGCGCCGTCC -> TTGCTCTCCGCGCCGTCCA
TTTGGATATCGGTTGAGGC -> TTGGATATCGGTTGAGGCG
TTTGGGAGCCTTCGTTAGA -> TTGGGAGCCTTCGTTAGAC
TTTGGGTGAAAACTAAAAA -> TTGGGTGAAAACTAAAAAA
TTTGTACGTTCCCGTGTCG -> TTGTACGTTCCCGTGTCGT
TTTGTAGCCGAATTTTCGG -> TTGTAGCCGAATTTTCGGT
TTTGTAGGCCGCAGGTCGC -> TTGTAGGCCGCAGGTCGCC
TTTGTCACTGGTAGTCCAG -> TTGTCACTGGTAGTCCAGA
TTTGTTAGAAATCGCCTGT -> TTGTTAGAAATCGCCTGTA
TTTTACCATATTCATAGCA -> TTTACCATATTCATAGCAT
TTTTACCTTAACTTGAGGA -> TTTACCTTAACTTGAGGAC
TTTTACGACGGTTAACAGT -> TTTACGACGGTTAACAGTC
TTTTACGCCTACGGCTACT -> TTTACGCCTACGGCTACTC
TTTTACGGACAGCTAGGGT -> TTTACGGACAGCTAGGGTC
TTTTACGTGACACCTAGTT -> TTTACGTGACACCTAGTTC
TTTTAGGCGATGTCAACAT -> TTTAGGCGATGTCAACATT
TTTTCCCCACATTCGTAGG -> TTTCCCCACATTCGTAGGG
TTTTCCTCGCGTCATATTC -> TTTCCTCGCGTCATATTCA
TTTTCGGTTCCTCCTACTC -> TTTCGGTTCCTCCTACTCG
TTTTGCACAGGATCAGGAC -> TTTGCACAGGATCAGGACG
TTTTGGGTGAAAACTAAAA -> TTTGGGTGAAAACTAAAAA
TTTTGTACGTTCCCGTGTC -> TTTGTACGTTCCCGTGTCG
TTTTGTAGCCGAATTTTCG -> TTTGTAGCCGAATTTTCGG
TTTTGTAGGCCGCAGGTCG -> TTTGTAGGCCGCAGGTCGC
TTTTTCCTCGCGTCATATT -> TTTTCCTCGCGTCATATTC
